wardpc,wardname,province,district,alt_name,districtpc,pop_2012,f_pop_2012,m_pop_2012,households
150318,18,Matabeleland North,Hwange,,1503,3750,1882,1868,1214
170117,17,Midlands,Chirumhanzu,,1701,1883,977,906,570
110433,33,Manicaland,Makoni,,1104,2471,1246,1225,730
120812,12,Mashonaland Central,Mbire,,1208,6785,3493,3292,1509
150428,28,Matabeleland North,Lupane,,1504,1360,650,710,258
150718,18,Matabeleland North,Umguza,,1507,2005,1041,964,388
102103,3,Bulawayo,Bulawayo,,1021,29920,15648,14272,8018
102101,1,Bulawayo,Bulawayo,,1021,12258,6466,5792,3867
180317,17,Masvingo,Chivi,,1803,4458,2467,1991,983
180314,14,Masvingo,Chivi,,1803,5904,3174,2730,1201
160113,13,Matabeleland South,Beitbridge,,1601,2322,1043,1279,611
180616,16,Masvingo,Mwenezi,,1806,15089,7776,7313,3201
170818,18,Midlands,Zvishavane,,1708,4867,2549,2318,945
150301,1,Matabeleland North,Hwange,,1503,4076,1919,2157,960
180126,26,Masvingo,Bikita,,1801,4016,2111,1905,867
180125,25,Masvingo,Bikita,,1801,4259,2257,2002,992
170202,2,Midlands,Gokwe North,,1702,16075,8446,7629,3227
150104,4,Matabeleland North,Binga,,1501,3323,1852,1471,868
150409,9,Matabeleland North,Lupane,,1504,3022,1547,1475,598
150405,5,Matabeleland North,Lupane,,1504,4440,2307,2133,842
102105,5,Bulawayo,Bulawayo,,1021,18757,9926,8831,5303
120324,24,Mashonaland Central,Guruve,,1203,2105,1063,1042,498
140502,2,Mashonaland West,Makonde,,1405,12457,6080,6377,2766
120316,16,Mashonaland Central,Guruve,,1203,6722,3441,3281,1511
160520,20,Matabeleland South,Insiza,,1605,8368,4393,3975,1585
160519,19,Matabeleland South,Insiza,,1605,7692,3895,3797,1488
150102,2,Matabeleland North,Binga,,1501,4821,2717,2104,1200
160604,4,Matabeleland South,Matobo,,1606,4936,2614,2322,999
160602,2,Matabeleland South,Matobo,,1606,6078,3079,2999,1387
102104,4,Bulawayo,Bulawayo,,1021,25112,13052,12060,7380
170816,16,Midlands,Zvishavane,,1708,3941,2105,1836,841
110321,21,Manicaland,Chipinge,,1103,9223,5106,4117,1977
110320,20,Manicaland,Chipinge,,1103,18085,10151,7934,4494
110323,23,Manicaland,Chipinge,,1103,8573,4599,3974,1744
180519,19,Masvingo,Masvingo,,1805,3067,1675,1392,717
180512,12,Masvingo,Masvingo,,1805,7518,4150,3368,1639
180331,31,Masvingo,Chivi,,1803,3789,2055,1734,865
180522,22,Masvingo,Masvingo,,1805,7954,4316,3638,1602
160415,15,Matabeleland South,Gwanda,,1604,4713,2597,2116,1082
160423,23,Matabeleland South,Gwanda,,1604,6723,3119,3604,1762
180315,15,Masvingo,Chivi,,1803,4968,2697,2271,1072
180318,18,Masvingo,Chivi,,1803,4216,2303,1913,945
150319,19,Matabeleland North,Hwange,,1503,946,418,528,320
150317,17,Matabeleland North,Hwange,,1503,3194,1726,1468,689
150121,21,Matabeleland North,Binga,,1501,17370,9060,8310,3237
150311,11,Matabeleland North,Hwange,,1503,2956,1600,1356,728
170636,36,Midlands,Mberengwa,,1706,8695,4070,4625,1695
170602,2,Midlands,Mberengwa,,1706,11655,5571,6084,2543
160625,25,Matabeleland South,Matobo,,1606,5922,2760,3162,1653
160615,15,Matabeleland South,Matobo,,1606,5089,2595,2494,1082
160709,9,Matabeleland South,Umzingwane,,1607,2289,1196,1093,494
160623,23,Matabeleland South,Matobo,,1606,975,409,566,249
160622,22,Matabeleland South,Matobo,,1606,638,200,438,214
160317,17,Matabeleland South,Mangwe,,1603,3959,2139,1820,770
170819,19,Midlands,Zvishavane,,1708,4353,1958,2395,1040
170815,15,Midlands,Zvishavane,,1708,5007,2660,2347,1106
160605,5,Matabeleland South,Matobo,,1606,4668,2511,2157,930
170817,17,Midlands,Zvishavane,,1708,5617,2993,2624,1191
150608,8,Matabeleland North,Tsholotsho,,1506,9050,4947,4103,1752
150601,1,Matabeleland North,Tsholotsho,,1506,3735,1901,1834,747
150607,7,Matabeleland North,Tsholotsho,,1506,4228,2178,2050,804
160222,22,Matabeleland South,Bulilima,,1602,3927,2186,1741,829
160208,8,Matabeleland South,Bulilima,,1602,4136,2353,1783,878
150424,24,Matabeleland North,Lupane,,1504,1283,663,620,270
150408,8,Matabeleland North,Lupane,,1504,3952,2040,1912,767
150413,13,Matabeleland North,Lupane,,1504,4305,2256,2049,898
150401,1,Matabeleland North,Lupane,,1504,2735,1470,1265,537
160720,20,Matabeleland South,Umzingwane,,1607,2108,1094,1014,483
160515,15,Matabeleland South,Insiza,,1605,5172,2546,2626,1422
160706,6,Matabeleland South,Umzingwane,,1607,4146,2157,1989,942
150610,10,Matabeleland North,Tsholotsho,,1506,3283,1689,1594,731
150119,19,Matabeleland North,Binga,,1501,5183,2780,2403,1088
150316,16,Matabeleland North,Hwange,,1503,3482,1868,1614,753
160110,10,Matabeleland South,Beitbridge,,1601,6009,3310,2699,1199
160112,12,Matabeleland South,Beitbridge,,1601,5958,3192,2766,1312
160114,14,Matabeleland South,Beitbridge,,1601,4658,1985,2673,1561
110317,17,Manicaland,Chipinge,,1103,12410,6795,5615,2521
110316,16,Manicaland,Chipinge,,1103,11807,6530,5277,2748
180325,25,Masvingo,Chivi,,1803,10893,6059,4834,2542
150609,9,Matabeleland North,Tsholotsho,,1506,6612,3525,3087,1291
150603,3,Matabeleland North,Tsholotsho,,1506,5349,2927,2422,1031
170814,14,Midlands,Zvishavane,,1708,6199,3007,3192,1314
170634,34,Midlands,Mberengwa,,1706,3153,1668,1485,660
170630,30,Midlands,Mberengwa,,1706,4552,2479,2073,938
170631,31,Midlands,Mberengwa,,1706,6932,3794,3138,1490
160414,14,Matabeleland South,Gwanda,,1604,5865,3219,2646,1389
160708,8,Matabeleland South,Umzingwane,,1607,2776,1423,1353,571
170601,1,Midlands,Mberengwa,,1706,4527,2217,2310,940
160510,10,Matabeleland South,Insiza,,1605,2280,1160,1120,444
160310,10,Matabeleland South,Mangwe,,1603,5104,2765,2339,1041
180224,24,Masvingo,Chiredzi,,1802,22378,11394,10984,4634
180232,32,Masvingo,Chiredzi,,1802,6204,3170,3034,1576
180521,21,Masvingo,Masvingo,,1805,3801,2021,1780,803
180511,11,Masvingo,Masvingo,,1805,5394,2943,2451,1173
160418,18,Matabeleland South,Gwanda,,1604,5518,2986,2532,1207
160417,17,Matabeleland South,Gwanda,,1604,5971,3230,2741,1283
160106,6,Matabeleland South,Beitbridge,,1601,6740,3491,3249,1654
160107,7,Matabeleland South,Beitbridge,,1601,2782,1458,1324,591
160103,3,Matabeleland South,Beitbridge,,1601,7143,4040,3103,1599
160101,1,Matabeleland South,Beitbridge,,1601,4271,2290,1981,928
180328,28,Masvingo,Chivi,,1803,7606,4066,3540,1600
180717,17,Masvingo,Zaka,,1807,3091,1636,1455,708
180724,24,Masvingo,Zaka,,1807,6148,3418,2730,1290
180723,23,Masvingo,Zaka,,1807,4065,2223,1842,853
180102,2,Masvingo,Bikita,,1801,8892,4911,3981,1957
180721,21,Masvingo,Zaka,,1807,5387,2924,2463,1155
180613,13,Masvingo,Mwenezi,,1806,29057,14974,14083,5801
180326,26,Masvingo,Chivi,,1803,7964,4411,3553,1759
180324,24,Masvingo,Chivi,,1803,4984,2737,2247,1120
170717,17,Midlands,Shurugwi,,1707,3617,1582,2035,817
170415,15,Midlands,Gweru,,1704,3210,1567,1643,803
150516,16,Matabeleland North,Nkayi,,1505,4746,2503,2243,982
150527,27,Matabeleland North,Nkayi,,1505,4127,2145,1982,733
150523,23,Matabeleland North,Nkayi,,1505,4029,2085,1944,730
140221,21,Mashonaland West,Hurungwe,,1402,11489,5618,5871,2458
140203,3,Mashonaland West,Hurungwe,,1402,10287,5182,5105,1714
172304,4,Midlands,Redcliff,,1723,4061,2118,1943,1023
170503,3,Midlands,Kwekwe,,1705,4917,2211,2706,1045
170416,16,Midlands,Gweru,,1704,5973,2710,3263,1437
102102,2,Bulawayo,Bulawayo,,1021,27824,14660,13164,7240
172308,8,Midlands,Redcliff,,1723,1964,1026,938,520
170302,2,Midlands,Gokwe South,,1703,7906,4102,3804,1573
170326,26,Midlands,Gokwe South,,1703,6321,3326,2995,1215
170608,8,Midlands,Mberengwa,,1706,4699,2518,2181,997
170616,16,Midlands,Mberengwa,,1706,3961,2160,1801,838
170627,27,Midlands,Mberengwa,,1706,3644,2025,1619,715
150210,10,Matabeleland North,Bubi,,1502,2291,953,1338,623
150201,1,Matabeleland North,Bubi,,1502,3624,1591,2033,769
170305,5,Midlands,Gokwe South,,1703,11868,6280,5588,2432
170320,20,Midlands,Gokwe South,,1703,6557,3463,3094,1344
172105,5,Midlands,Gweru Urban,,1721,13945,7238,6707,3907
172104,4,Midlands,Gweru Urban,,1721,8532,4710,3822,2076
170101,1,Midlands,Chirumhanzu,,1701,4030,2207,1823,1042
170701,1,Midlands,Shurugwi,,1707,3524,1809,1715,707
170328,28,Midlands,Gokwe South,,1703,3322,1629,1693,644
170509,9,Midlands,Kwekwe,,1705,3764,1926,1838,882
180725,25,Masvingo,Zaka,,1807,5946,3212,2734,1317
180720,20,Masvingo,Zaka,,1807,5570,3062,2508,1208
180523,23,Masvingo,Masvingo,,1805,4305,2228,2077,958
180525,25,Masvingo,Masvingo,,1805,3136,1715,1421,671
180531,31,Masvingo,Masvingo,,1805,2622,1347,1275,531
150710,10,Matabeleland North,Umguza,,1507,2887,1430,1457,607
150205,5,Matabeleland North,Bubi,,1502,1483,754,729,314
170716,16,Midlands,Shurugwi,,1707,2718,1307,1411,567
170118,18,Midlands,Chirumhanzu,,1701,1844,954,890,407
170111,11,Midlands,Chirumhanzu,,1701,3487,1787,1700,753
150515,15,Matabeleland North,Nkayi,,1505,4589,2454,2135,901
170418,18,Midlands,Gweru,,1704,6690,3283,3407,1476
170330,30,Midlands,Gokwe South,,1703,4221,2188,2033,845
150220,20,Matabeleland North,Bubi,,1502,4193,2025,2168,863
170504,4,Midlands,Kwekwe,,1705,3510,1507,2003,908
170531,31,Midlands,Kwekwe,,1705,10232,4646,5586,2530
142715,15,Mashonaland West,Mhondoro-Ngezi,,1427,5104,2495,2609,1056
160521,21,Matabeleland South,Insiza,,1605,6650,3281,3369,1293
170417,17,Midlands,Gweru,,1704,3258,1598,1660,717
180728,28,Masvingo,Zaka,,1807,5746,3205,2541,1266
180524,24,Masvingo,Masvingo,,1805,5195,2893,2302,1175
180730,30,Masvingo,Zaka,,1807,4892,2664,2228,1066
180220,20,Masvingo,Chiredzi,,1802,18558,9788,8770,3874
170508,8,Midlands,Kwekwe,,1705,10499,5518,4981,2295
170325,25,Midlands,Gokwe South,,1703,10981,5612,5369,2311
170327,27,Midlands,Gokwe South,,1703,10201,5223,4978,1956
142710,10,Mashonaland West,Mhondoro-Ngezi,,1427,3369,1652,1717,729
142712,12,Mashonaland West,Mhondoro-Ngezi,,1427,7558,3717,3841,1562
150507,7,Matabeleland North,Nkayi,,1505,3188,1658,1530,650
150526,26,Matabeleland North,Nkayi,,1505,3702,1942,1760,736
150209,9,Matabeleland North,Bubi,,1502,864,417,447,179
150208,8,Matabeleland North,Bubi,,1502,1374,621,753,318
150219,19,Matabeleland North,Bubi,,1502,2545,1201,1344,483
170401,1,Midlands,Gweru,,1704,4289,2076,2213,944
170419,19,Midlands,Gweru,,1704,4062,2022,2040,827
180403,3,Masvingo,Gutu,,1804,4538,2373,2165,863
180409,9,Masvingo,Gutu,,1804,5583,3062,2521,1361
130622,22,Mashonaland East,Murehwa,,1306,15182,7472,7710,3372
130623,23,Mashonaland East,Murehwa,,1306,10758,5277,5481,2510
130813,13,Mashonaland East,Seke,,1308,2630,1357,1273,694
130814,14,Mashonaland East,Seke,,1308,3846,1806,2040,1104
130812,12,Mashonaland East,Seke,,1308,4395,2069,2326,1221
130820,20,Mashonaland East,Seke,,1308,4884,2303,2581,1153
110431,31,Manicaland,Makoni,,1104,9503,4953,4550,1701
110112,12,Manicaland,Buhera,,1101,7746,4092,3654,1773
110439,39,Manicaland,Makoni,,1104,4779,2460,2319,1084
110425,25,Manicaland,Makoni,,1104,7593,4074,3519,1873
180416,16,Masvingo,Gutu,,1804,7273,3979,3294,1710
110124,24,Manicaland,Buhera,,1101,8920,4738,4182,1997
110437,37,Manicaland,Makoni,,1104,11437,5439,5998,2961
110121,21,Manicaland,Buhera,,1101,7034,3820,3214,1570
110421,21,Manicaland,Makoni,,1104,4149,2246,1903,996
110419,19,Manicaland,Makoni,,1104,5700,2902,2798,1281
180506,6,Masvingo,Masvingo,,1805,10153,5050,5103,2347
182110,10,Masvingo,Masvingo Urban,,1821,5976,2968,3008,1375
180507,7,Masvingo,Masvingo,,1805,5548,2707,2841,1363
182109,9,Masvingo,Masvingo Urban,,1821,5778,3049,2729,1357
140102,2,Mashonaland West,Chegutu,,1401,8295,4344,3951,2037
140101,1,Mashonaland West,Chegutu,,1401,4525,2339,2186,1098
110415,15,Manicaland,Makoni,,1104,8090,4303,3787,1996
130101,1,Mashonaland East,Chikomba,,1301,4242,1931,2311,1144
110118,18,Manicaland,Buhera,,1101,6924,3733,3191,1527
110132,32,Manicaland,Buhera,,1101,6231,3379,2852,1400
142701,1,Mashonaland West,Mhondoro-Ngezi,,1427,4427,2350,2077,1069
102110,10,Bulawayo,Bulawayo,,1021,29436,15664,13772,7605
110126,26,Manicaland,Buhera,,1101,7562,4131,3431,1710
180120,20,Masvingo,Bikita,,1801,7473,4127,3346,1779
180432,32,Masvingo,Gutu,,1804,8553,4377,4176,1888
170102,2,Midlands,Chirumhanzu,,1701,3825,2114,1711,903
182108,8,Masvingo,Masvingo Urban,,1821,1579,754,825,499
130113,13,Mashonaland East,Chikomba,,1301,410,186,224,110
130108,8,Mashonaland East,Chikomba,,1301,9604,4646,4958,2170
110529,29,Manicaland,Mutare,,1105,9814,4981,4833,2100
110202,2,Manicaland,Chimanimani,,1102,3838,2048,1790,890
110201,1,Manicaland,Chimanimani,,1102,5339,2494,2845,1285
130312,12,Mashonaland East,Hwedza,,1303,4117,2185,1932,1052
110612,12,Manicaland,Mutasa,,1106,6008,3299,2709,1493
110614,14,Manicaland,Mutasa,,1106,2562,1393,1169,713
110522,22,Manicaland,Mutare,,1105,9041,4686,4355,1986
110123,23,Manicaland,Buhera,,1101,11855,6294,5561,2632
110524,24,Manicaland,Mutare,,1105,8726,4566,4160,1960
110530,30,Manicaland,Mutare,,1105,12649,5790,6859,2428
182105,5,Masvingo,Masvingo Urban,,1821,9884,5353,4531,2656
182103,3,Masvingo,Masvingo Urban,,1821,13664,7367,6297,3777
110613,13,Manicaland,Mutasa,,1106,4041,2166,1875,1023
130408,8,Mashonaland East,Marondera,,1304,4584,2161,2423,1077
110726,26,Manicaland,Nyanga,,1107,2690,1119,1571,998
140106,6,Mashonaland West,Chegutu,,1401,3463,1822,1641,850
130314,14,Mashonaland East,Hwedza,,1303,1855,915,940,454
110420,20,Manicaland,Makoni,,1104,6114,3102,3012,1512
182106,6,Masvingo,Masvingo Urban,,1821,9958,5510,4448,2690
180412,12,Masvingo,Gutu,,1804,6745,3637,3108,1649
110119,19,Manicaland,Buhera,,1101,5476,2941,2535,1267
180406,6,Masvingo,Gutu,,1804,4854,2652,2202,1200
180407,7,Masvingo,Gutu,,1804,6153,3201,2952,1427
130313,13,Mashonaland East,Hwedza,,1303,2414,1228,1186,535
110428,28,Manicaland,Makoni,,1104,4531,2394,2137,1064
180405,5,Masvingo,Gutu,,1804,4276,2281,1995,1024
150124,24,Matabeleland North,Binga,,1501,6240,3207,3033,1570
150106,6,Matabeleland North,Binga,,1501,4913,2713,2200,1254
150105,5,Matabeleland North,Binga,,1501,4517,2524,1993,1117
110412,12,Manicaland,Makoni,,1104,12103,6326,5777,2908
140205,5,Mashonaland West,Hurungwe,,1402,5497,2586,2911,1265
142610,10,Mashonaland West,Karoi,,1426,2368,1294,1074,619
140501,1,Mashonaland West,Makonde,,1405,7926,3781,4145,1710
140207,7,Mashonaland West,Hurungwe,,1402,13491,6587,6904,3329
170106,6,Midlands,Chirumhanzu,,1701,3486,1909,1577,846
170309,9,Midlands,Gokwe South,,1703,18535,9652,8883,3736
170204,4,Midlands,Gokwe North,,1702,10056,5253,4803,1962
142609,9,Mashonaland West,Karoi,,1426,2003,1087,916,511
140518,18,Mashonaland West,Makonde,,1405,5417,2657,2760,1204
170222,22,Midlands,Gokwe North,,1702,8187,3847,4340,1613
170214,14,Midlands,Gokwe North,,1702,6699,3530,3169,1470
170215,15,Midlands,Gokwe North,,1702,6715,3499,3216,1482
182101,1,Masvingo,Masvingo Urban,,1821,4569,2422,2147,1385
180124,24,Masvingo,Bikita,,1801,4503,2490,2013,1047
110528,28,Manicaland,Mutare,,1105,5830,3100,2730,1305
180401,1,Masvingo,Gutu,,1804,10369,5185,5184,2224
110120,20,Manicaland,Buhera,,1101,7194,3837,3357,1607
110122,22,Manicaland,Buhera,,1101,12425,6567,5858,2722
110611,11,Manicaland,Mutasa,,1106,10985,5907,5078,2680
110609,9,Manicaland,Mutasa,,1106,5541,3073,2468,1429
110438,38,Manicaland,Makoni,,1104,5064,2323,2741,1270
142608,8,Mashonaland West,Karoi,,1426,1804,945,859,485
140620,20,Mashonaland West,Zvimba,,1406,9719,4827,4892,2328
140619,19,Mashonaland West,Zvimba,,1406,9449,4658,4791,2233
140633,33,Mashonaland West,Zvimba,,1406,8419,4073,4346,1880
130624,24,Mashonaland East,Murehwa,,1306,11605,5433,6172,2687
130617,17,Mashonaland East,Murehwa,,1306,4815,2490,2325,1081
130202,2,Mashonaland East,Goromonzi,,1302,12456,6546,5910,2813
130201,1,Mashonaland East,Goromonzi,,1302,8693,4482,4211,2054
140510,10,Mashonaland West,Makonde,,1405,2975,1460,1515,671
142816,16,Mashonaland West,Sanyati,,1428,6411,3143,3268,1327
170205,5,Midlands,Gokwe North,,1702,8821,4597,4224,1751
170203,3,Midlands,Gokwe North,,1702,13798,7272,6526,1714
140208,8,Mashonaland West,Hurungwe,,1402,15345,7709,7636,3295
140204,4,Mashonaland West,Hurungwe,,1402,8476,4127,4349,1797
140516,16,Mashonaland West,Makonde,,1405,5324,2657,2667,1135
140508,8,Mashonaland West,Makonde,,1405,22166,11080,11086,4573
120602,2,Mashonaland Central,Rushinga,,1206,1584,791,793,365
102129,29,Bulawayo,Bulawayo,,1021,18749,10281,8468,4669
102114,14,Bulawayo,Bulawayo,,1021,20588,11032,9556,5200
130621,21,Mashonaland East,Murehwa,,1306,5660,2966,2694,1398
130604,4,Mashonaland East,Murehwa,,1306,5988,3142,2846,1757
130603,3,Mashonaland East,Murehwa,,1306,5435,2757,2678,1293
102108,8,Bulawayo,Bulawayo,,1021,24260,12923,11337,5830
130204,4,Mashonaland East,Goromonzi,,1302,30123,15658,14465,7211
130605,5,Mashonaland East,Murehwa,,1306,3614,1948,1666,891
130606,6,Mashonaland East,Murehwa,,1306,838,401,437,200
130719,19,Mashonaland East,Mutoko,,1307,6902,3599,3303,1628
130724,24,Mashonaland East,Mutoko,,1307,876,426,450,208
130610,10,Mashonaland East,Murehwa,,1306,4796,2535,2261,1117
130726,26,Mashonaland East,Mutoko,,1307,6119,2983,3136,1344
130917,17,Mashonaland East,Uzumba Maramba Pfungwe,,1309,5638,2953,2685,1191
130916,16,Mashonaland East,Uzumba Maramba Pfungwe,,1309,5844,2998,2846,1289
120229,29,Mashonaland Central,Centenary,,1202,2735,1288,1447,579
120321,21,Mashonaland Central,Guruve,,1203,5923,2852,3071,1198
130205,5,Mashonaland East,Goromonzi,,1302,5829,2948,2881,1325
120419,19,Mashonaland Central,Mazowe,,1204,7848,5048,2800,9785
120509,9,Mashonaland Central,Mount Darwin,,1205,1883,997,886,485
120517,17,Mashonaland Central,Mount Darwin,,1205,6422,3369,3053,1451
120518,18,Mashonaland Central,Mount Darwin,,1205,6732,3435,3297,1403
120608,8,Mashonaland Central,Rushinga,,1206,3645,1885,1760,846
120116,16,Mashonaland Central,Bindura,,1201,8562,4530,4032,2071
120115,15,Mashonaland Central,Bindura,,1201,5434,2854,2580,1329
120117,17,Mashonaland Central,Bindura,,1201,5722,2982,2740,1366
120538,38,Mashonaland Central,Mount Darwin,,1205,3500,1844,1656,780
120537,37,Mashonaland Central,Mount Darwin,,1205,2901,1486,1415,714
120609,9,Mashonaland Central,Rushinga,,1206,3189,1695,1494,684
120434,34,Mashonaland Central,Mazowe,,1204,8792,4172,4620,2134
120423,23,Mashonaland Central,Mazowe,,1204,4795,2295,2500,1206
120611,11,Mashonaland Central,Rushinga,,1206,1377,703,674,325
120610,10,Mashonaland Central,Rushinga,,1206,4080,2109,1971,921
140115,15,Mashonaland West,Chegutu,,1401,8075,3855,4220,1983
140625,25,Mashonaland West,Zvimba,,1406,7685,3581,4104,1933
120303,3,Mashonaland Central,Guruve,,1203,1856,920,936,397
120510,10,Mashonaland Central,Mount Darwin,,1205,8939,4608,4331,2058
120515,15,Mashonaland Central,Mount Darwin,,1205,9851,5061,4790,2169
110703,3,Manicaland,Nyanga,,1107,6132,3293,2839,1478
110705,5,Manicaland,Nyanga,,1107,5987,3123,2864,1340
130210,10,Mashonaland East,Goromonzi,,1302,7142,3773,3369,1807
120617,17,Mashonaland Central,Rushinga,,1206,2921,1547,1374,677
120607,7,Mashonaland Central,Rushinga,,1206,2503,1325,1178,567
120426,26,Mashonaland Central,Mazowe,,1204,6421,3182,3239,1464
120429,29,Mashonaland Central,Mazowe,,1204,8370,4119,4251,1978
120530,30,Mashonaland Central,Mount Darwin,,1205,1046,508,538,211
120716,16,Mashonaland Central,Shamva,,1207,7380,3649,3731,1614
120622,22,Mashonaland Central,Rushinga,,1206,3296,1668,1628,748
160108,8,Matabeleland South,Beitbridge,,1601,3725,2044,1681,828
160114,14,Matabeleland South,Beitbridge,,1601,4658,1985,2673,1561
102109,9,Bulawayo,Bulawayo,,1021,27836,14747,13089,7187
170506,6,Midlands,Kwekwe,,1705,6399,3266,3133,1316
170324,24,Midlands,Gokwe South,,1703,18716,9353,9363,4080
120212,12,Mashonaland Central,Centenary,,1202,4860,2371,2489,1164
120211,11,Mashonaland Central,Centenary,,1202,3212,1612,1600,674
120606,6,Mashonaland Central,Rushinga,,1206,1941,996,945,415
130618,18,Mashonaland East,Murehwa,,1306,3596,1869,1727,947
120512,12,Mashonaland Central,Mount Darwin,,1205,6308,3321,2987,1371
130612,12,Mashonaland East,Murehwa,,1306,9353,4893,4460,2376
120304,4,Mashonaland Central,Guruve,,1203,4704,2442,2262,1044
120302,2,Mashonaland Central,Guruve,,1203,3842,1840,2002,727
130725,25,Mashonaland East,Mutoko,,1307,9316,4768,4548,2086
120225,25,Mashonaland Central,Centenary,,1202,2833,1409,1424,594
120216,16,Mashonaland Central,Centenary,,1202,1659,818,841,343
120519,19,Mashonaland Central,Mount Darwin,,1205,8946,4363,4583,1929
120318,18,Mashonaland Central,Guruve,,1203,4388,2245,2143,1058
102118,18,Bulawayo,Bulawayo,,1021,22941,12439,10502,5928
150611,11,Matabeleland North,Tsholotsho,,1506,3946,2148,1798,1159
130607,7,Mashonaland East,Murehwa,,1306,807,420,387,186
130206,6,Mashonaland East,Goromonzi,,1302,12054,5837,6217,3170
120536,36,Mashonaland Central,Mount Darwin,,1205,8024,4172,3852,1850
130211,11,Mashonaland East,Goromonzi,,1302,8501,4501,4000,2171
130619,19,Mashonaland East,Murehwa,,1306,2409,1279,1130,598
120620,20,Mashonaland Central,Rushinga,,1206,2353,1194,1159,536
120430,30,Mashonaland Central,Mazowe,,1204,8403,4118,4285,1583
120424,24,Mashonaland Central,Mazowe,,1204,7261,3679,3582,1783
120431,31,Mashonaland Central,Mazowe,,1204,6567,3203,3364,1575
120314,14,Mashonaland Central,Guruve,,1203,4888,2293,2595,1213
120301,1,Mashonaland Central,Guruve,,1203,8713,4211,4502,1916
162203,3,Matabeleland South,Beitbridge Urban,,1622,4198,2059,2139,1176
160115,15,Matabeleland South,Beitbridge,,1601,4248,2277,1971,982
162202,2,Matabeleland South,Beitbridge Urban,,1622,2173,1058,1115,601
160416,16,Matabeleland South,Gwanda,,1604,5467,2937,2530,1226
160109,9,Matabeleland South,Beitbridge,,1601,4810,2497,2313,1123
160420,20,Matabeleland South,Gwanda,,1604,4618,2512,2106,968
162205,5,Matabeleland South,Beitbridge Urban,,1622,7548,3936,3612,2178
102117,17,Bulawayo,Bulawayo,,1021,17267,9207,8060,4195
102119,19,Bulawayo,Bulawayo,,1021,20842,11199,9643,5275
160424,24,Matabeleland South,Gwanda,,1604,2698,1505,1193,673
162206,6,Matabeleland South,Beitbridge Urban,,1622,12356,6312,6044,3917
160105,5,Matabeleland South,Beitbridge,,1601,9927,5539,4388,2280
162204,4,Matabeleland South,Beitbridge Urban,,1622,10778,5545,5233,3351
160619,19,Matabeleland South,Matobo,,1606,5720,3080,2640,1339
150622,22,Matabeleland North,Tsholotsho,,1506,7927,4329,3598,1881
150606,6,Matabeleland North,Tsholotsho,,1506,7341,3897,3444,1532
162201,1,Matabeleland South,Beitbridge Urban,,1622,5165,2731,2434,736
180535,35,Masvingo,Masvingo,,1805,5151,2497,2654,1346
150616,16,Matabeleland North,Tsholotsho,,1506,5637,3130,2507,1213
150614,14,Matabeleland North,Tsholotsho,,1506,3642,2070,1572,779
180210,10,Masvingo,Chiredzi,,1802,10018,5458,4560,1960
180212,12,Masvingo,Chiredzi,,1802,416,194,222,79
180211,11,Masvingo,Chiredzi,,1802,11605,6565,5040,2337
170632,32,Midlands,Mberengwa,,1706,5980,3163,2817,1280
160601,1,Matabeleland South,Matobo,,1606,3982,2149,1833,854
160411,11,Matabeleland South,Gwanda,,1604,4593,2478,2115,1079
102116,16,Bulawayo,Bulawayo,,1021,16923,9393,7530,4170
180213,13,Masvingo,Chiredzi,,1802,4097,2266,1831,835
160311,11,Matabeleland South,Mangwe,,1603,3550,1431,2119,865
160315,15,Matabeleland South,Mangwe,,1603,5802,2916,2886,1224
140311,11,Mashonaland West,Kadoma Urban,,1403,5783,3014,2769,1529
140317,17,Mashonaland West,Kadoma Urban,,1403,3565,1861,1704,921
160616,16,Matabeleland South,Matobo,,1606,4716,2486,2230,945
160617,17,Matabeleland South,Matobo,,1606,4268,2215,2053,918
160613,13,Matabeleland South,Matobo,,1606,3680,1996,1684,872
160621,21,Matabeleland South,Matobo,,1606,1106,433,673,277
160614,14,Matabeleland South,Matobo,,1606,4326,2374,1952,980
160621,21,Matabeleland South,Matobo,,1606,1106,433,673,277
160307,7,Matabeleland South,Mangwe,,1603,2991,1610,1381,617
160607,7,Matabeleland South,Matobo,,1606,4871,2618,2253,1043
162110,10,Matabeleland South,Gwanda Urban,,1621,958,472,486,281
162102,2,Matabeleland South,Gwanda Urban,,1621,1072,602,470,254
160606,6,Matabeleland South,Matobo,,1606,5358,2959,2399,1046
160305,5,Matabeleland South,Mangwe,,1603,3167,1680,1487,778
160612,12,Matabeleland South,Matobo,,1606,4141,2158,1983,854
160611,11,Matabeleland South,Matobo,,1606,3358,1811,1547,709
160609,9,Matabeleland South,Matobo,,1606,3200,1660,1540,665
160608,8,Matabeleland South,Matobo,,1606,4314,2322,1992,896
182104,4,Masvingo,Masvingo Urban,,1821,11806,6445,5361,3106
162305,5,Matabeleland South,Plumtree,,1623,616,278,338,170
160312,12,Matabeleland South,Mangwe,,1603,2713,1411,1302,562
160618,18,Matabeleland South,Matobo,,1606,3521,1875,1646,722
160301,1,Matabeleland South,Mangwe,,1603,3999,2159,1840,745
160314,14,Matabeleland South,Mangwe,,1603,2110,1114,996,428
160303,3,Matabeleland South,Mangwe,,1603,4533,2432,2101,911
160603,3,Matabeleland South,Matobo,,1606,3521,1847,1674,827
162104,4,Matabeleland South,Gwanda Urban,,1621,2503,1348,1155,663
170613,13,Midlands,Mberengwa,,1706,4329,2290,2039,895
160509,9,Matabeleland South,Insiza,,1605,4450,2338,2112,949
160711,11,Matabeleland South,Umzingwane,,1607,2157,1124,1033,476
160707,7,Matabeleland South,Umzingwane,,1607,2950,1515,1435,643
160404,4,Matabeleland South,Gwanda,,1604,4695,2521,2174,1017
160713,13,Matabeleland South,Umzingwane,,1607,1683,949,734,306
160710,10,Matabeleland South,Umzingwane,,1607,1138,615,523,244
182208,8,Masvingo,Chiredzi Urban,,1822,4224,2257,1967,1083
182205,5,Masvingo,Chiredzi Urban,,1822,5296,2786,2510,1566
182207,7,Masvingo,Chiredzi Urban,,1822,3151,1609,1542,844
160402,2,Matabeleland South,Gwanda,,1604,3727,1929,1798,798
160421,21,Matabeleland South,Gwanda,,1604,7812,3242,4570,2229
162105,5,Matabeleland South,Gwanda Urban,,1621,1906,1004,902,501
182206,6,Masvingo,Chiredzi Urban,,1822,3081,1640,1441,871
142801,1,Mashonaland West,Sanyati,,1428,9318,4302,5016,2196
140315,15,Mashonaland West,Kadoma Urban,,1403,5518,2956,2562,1311
160511,11,Matabeleland South,Insiza,,1605,2714,1488,1226,537
160506,6,Matabeleland South,Insiza,,1605,3761,2010,1751,811
160503,3,Matabeleland South,Insiza,,1605,5259,2801,2458,1096
160401,1,Matabeleland South,Gwanda,,1604,5164,2725,2439,1102
160410,10,Matabeleland South,Gwanda,,1604,363,92,271,98
180618,18,Masvingo,Mwenezi,,1806,3718,2001,1717,1080
180614,14,Masvingo,Mwenezi,,1806,10095,5318,4777,1898
110715,15,Manicaland,Nyanga,,1107,9209,4880,4329,2132
160505,5,Matabeleland South,Insiza,,1605,4442,2349,2093,955
160512,12,Matabeleland South,Insiza,,1605,2263,1137,1126,452
162103,3,Matabeleland South,Gwanda Urban,,1621,725,349,376,194
160408,8,Matabeleland South,Gwanda,,1604,5853,2996,2857,1350
162109,9,Matabeleland South,Gwanda Urban,,1621,2532,1334,1198,695
162108,8,Matabeleland South,Gwanda Urban,,1621,2927,1499,1428,887
160422,22,Matabeleland South,Gwanda,,1604,7617,3238,4379,1966
162101,1,Matabeleland South,Gwanda Urban,,1621,1361,634,727,378
160413,13,Matabeleland South,Gwanda,,1604,7741,4104,3637,1644
160409,9,Matabeleland South,Gwanda,,1604,3756,1937,1819,773
170606,6,Midlands,Mberengwa,,1706,8770,4863,3907,1856
170605,5,Midlands,Mberengwa,,1706,7101,3880,3221,1459
110404,4,Manicaland,Makoni,,1104,497,242,255,100
110402,2,Manicaland,Makoni,,1104,6314,3176,3138,1492
160504,4,Matabeleland South,Insiza,,1605,5273,2759,2514,1059
160502,2,Matabeleland South,Insiza,,1605,4853,2510,2343,1024
160517,17,Matabeleland South,Insiza,,1605,5502,2880,2622,1130
160403,3,Matabeleland South,Gwanda,,1604,3593,1919,1674,785
160516,16,Matabeleland South,Insiza,,1605,3121,1371,1750,652
180534,34,Masvingo,Masvingo,,1805,6201,3391,2810,1249
102111,11,Bulawayo,Bulawayo,,1021,19249,10380,8869,4697
160501,1,Matabeleland South,Insiza,,1605,3869,1968,1901,783
160712,12,Matabeleland South,Umzingwane,,1607,3730,1918,1812,806
160405,5,Matabeleland South,Gwanda,,1604,1295,667,628,285
170635,35,Midlands,Mberengwa,,1706,5370,2631,2739,1073
160406,6,Matabeleland South,Gwanda,,1604,4911,2518,2393,1023
160407,7,Matabeleland South,Gwanda,,1604,3146,1656,1490,655
160508,8,Matabeleland South,Insiza,,1605,852,414,438,150
180322,22,Masvingo,Chivi,,1803,5536,3019,2517,1190
180320,20,Masvingo,Chivi,,1803,6244,3440,2804,1366
180323,23,Masvingo,Chivi,,1803,5040,2772,2268,1141
180602,2,Masvingo,Mwenezi,,1806,5288,2930,2358,1065
180606,6,Masvingo,Mwenezi,,1806,4346,2386,1960,840
180605,5,Masvingo,Mwenezi,,1806,10291,5723,4568,2134
180601,1,Masvingo,Mwenezi,,1806,5589,3155,2434,1230
180609,9,Masvingo,Mwenezi,,1806,7034,3859,3175,1443
180611,11,Masvingo,Mwenezi,,1806,6194,3553,2641,1255
180617,17,Masvingo,Mwenezi,,1806,21355,11453,9902,4073
170628,28,Midlands,Mberengwa,,1706,3864,2113,1751,792
180603,3,Masvingo,Mwenezi,,1806,7986,4457,3529,1622
180607,7,Masvingo,Mwenezi,,1806,6154,3412,2742,1261
180319,19,Masvingo,Chivi,,1803,6422,3475,2947,1395
180608,8,Masvingo,Mwenezi,,1806,6580,3662,2918,1282
170626,26,Midlands,Mberengwa,,1706,5978,3267,2711,1216
170622,22,Midlands,Mberengwa,,1706,4134,2321,1813,861
170624,24,Midlands,Mberengwa,,1706,4496,2458,2038,897
170603,3,Midlands,Mberengwa,,1706,5825,3149,2676,1262
180610,10,Masvingo,Mwenezi,,1806,7708,4361,3347,1528
170617,17,Midlands,Mberengwa,,1706,4593,2438,2155,985
170618,18,Midlands,Mberengwa,,1706,7935,4360,3575,1723
170633,33,Midlands,Mberengwa,,1706,3090,1733,1357,662
170629,29,Midlands,Mberengwa,,1706,5403,2868,2535,1080
170615,15,Midlands,Mberengwa,,1706,3910,2071,1839,806
170614,14,Midlands,Mberengwa,,1706,3749,2028,1721,696
170623,23,Midlands,Mberengwa,,1706,4713,2631,2082,999
170619,19,Midlands,Mberengwa,,1706,6437,3559,2878,1299
170620,20,Midlands,Mberengwa,,1706,3620,2014,1606,755
170604,4,Midlands,Mberengwa,,1706,6119,3264,2855,1373
170607,7,Midlands,Mberengwa,,1706,3728,2013,1715,829
170609,9,Midlands,Mberengwa,,1706,3565,1892,1673,732
170610,10,Midlands,Mberengwa,,1706,3718,1910,1808,769
170621,21,Midlands,Mberengwa,,1706,4781,2571,2210,956
180321,21,Masvingo,Chivi,,1803,5223,2891,2332,1079
180526,26,Masvingo,Masvingo,,1805,5859,3147,2712,1360
180217,17,Masvingo,Chiredzi,,1802,18856,9936,8920,4043
180230,30,Masvingo,Chiredzi,,1802,9182,4084,5098,2829
180227,27,Masvingo,Chiredzi,,1802,6653,3242,3411,1946
110322,22,Manicaland,Chipinge,,1103,10413,5677,4736,2212
110324,24,Manicaland,Chipinge,,1103,18525,10112,8413,3935
160215,15,Matabeleland South,Bulilima,,1602,1825,922,903,367
160212,12,Matabeleland South,Bulilima,,1602,6468,3573,2895,1231
160209,9,Matabeleland South,Bulilima,,1602,5302,2847,2455,1279
160210,10,Matabeleland South,Bulilima,,1602,3951,2104,1847,883
160213,13,Matabeleland South,Bulilima,,1602,3157,1759,1398,646
180218,18,Masvingo,Chiredzi,,1802,13254,6603,6651,3794
180228,28,Masvingo,Chiredzi,,1802,14423,6877,7546,4216
180216,16,Masvingo,Chiredzi,,1802,20683,10795,9888,4378
180219,19,Masvingo,Chiredzi,,1802,12283,5720,6563,3474
180206,6,Masvingo,Chiredzi,,1802,7549,4128,3421,1450
180209,9,Masvingo,Chiredzi,,1802,3643,2016,1627,674
180231,31,Masvingo,Chiredzi,,1802,8477,3863,4614,2752
180529,29,Masvingo,Masvingo,,1805,7161,3879,3282,1586
180103,3,Masvingo,Bikita,,1801,7206,3978,3228,1704
180101,1,Masvingo,Bikita,,1801,3646,1953,1693,738
180731,31,Masvingo,Zaka,,1807,5067,2776,2291,1090
180223,23,Masvingo,Chiredzi,,1802,5431,2903,2528,1129
180527,27,Masvingo,Masvingo,,1805,2776,1510,1266,583
110723,23,Manicaland,Nyanga,,1107,5634,2723,2911,1210
180732,32,Masvingo,Zaka,,1807,5164,2859,2305,1132
180229,29,Masvingo,Chiredzi,,1802,5851,2726,3125,1476
182202,2,Masvingo,Chiredzi Urban,,1822,2499,1276,1223,628
182201,1,Masvingo,Chiredzi Urban,,1822,1195,580,615,241
180727,27,Masvingo,Zaka,,1807,6073,3252,2821,1291
180222,22,Masvingo,Chiredzi,,1802,6331,3413,2918,1378
110329,29,Manicaland,Chipinge,,1103,12949,6976,5973,2450
150612,12,Matabeleland North,Tsholotsho,,1506,7003,3640,3363,1471
150621,21,Matabeleland North,Tsholotsho,,1506,2296,1262,1034,443
110403,3,Manicaland,Makoni,,1104,8277,4308,3969,2043
110407,7,Manicaland,Makoni,,1104,11603,5943,5660,2538
180203,3,Masvingo,Chiredzi,,1802,3323,1860,1463,725
110326,26,Manicaland,Chipinge,,1103,17878,9485,8393,4337
110327,27,Manicaland,Chipinge,,1103,7176,4127,3049,1569
160218,18,Matabeleland South,Bulilima,,1602,966,494,472,182
150618,18,Matabeleland North,Tsholotsho,,1506,4548,2418,2130,925
160221,21,Matabeleland South,Bulilima,,1602,2075,1099,976,468
160216,16,Matabeleland South,Bulilima,,1602,1885,961,924,388
160201,1,Matabeleland South,Bulilima,,1602,5105,2753,2352,1133
102128,28,Bulawayo,Bulawayo,,1021,45348,24858,20490,11342
110409,9,Manicaland,Makoni,,1104,9159,4659,4500,1935
110408,8,Manicaland,Makoni,,1104,13273,6568,6705,2876
180202,2,Masvingo,Chiredzi,,1802,4030,2247,1783,890
140202,2,Mashonaland West,Hurungwe,,1402,11243,5529,5714,2406
140212,12,Mashonaland West,Hurungwe,,1402,8963,4460,4503,1939
180201,1,Masvingo,Chiredzi,,1802,4186,2242,1944,952
180225,25,Masvingo,Chiredzi,,1802,3107,1724,1383,696
180204,4,Masvingo,Chiredzi,,1802,5651,3098,2553,1305
180205,5,Masvingo,Chiredzi,,1802,4366,2409,1957,986
110315,15,Manicaland,Chipinge,,1103,7032,3852,3180,1550
160204,4,Matabeleland South,Bulilima,,1602,4953,2548,2405,1098
102113,13,Bulawayo,Bulawayo,,1021,19763,10286,9477,5130
102127,27,Bulawayo,Bulawayo,,1021,31259,17400,13859,7450
102107,7,Bulawayo,Bulawayo,,1021,17910,9190,8720,4802
102120,20,Bulawayo,Bulawayo,,1021,19029,10440,8589,4547
102121,21,Bulawayo,Bulawayo,,1021,28473,14896,13577,7010
102122,22,Bulawayo,Bulawayo,,1021,19447,10668,8779,4798
102124,24,Bulawayo,Bulawayo,,1021,23847,12611,11236,6011
102123,23,Bulawayo,Bulawayo,,1021,19500,10605,8895,4909
140214,14,Mashonaland West,Hurungwe,,1402,26590,13517,13073,5577
140412,12,Mashonaland West,Kariba,,1404,6105,2924,3181,1509
140217,17,Mashonaland West,Hurungwe,,1402,8409,4317,4092,1822
102125,25,Bulawayo,Bulawayo,,1021,24987,13349,11638,6038
102106,6,Bulawayo,Bulawayo,,1021,13404,7181,6223,3479
102115,15,Bulawayo,Bulawayo,,1021,12876,7095,5781,3089
160220,20,Matabeleland South,Bulilima,,1602,2089,1082,1007,460
160217,17,Matabeleland South,Bulilima,,1602,373,189,184,80
150620,20,Matabeleland North,Tsholotsho,,1506,1868,899,969,417
160219,19,Matabeleland South,Bulilima,,1602,5956,2979,2977,1251
150713,13,Matabeleland North,Umguza,,1507,2488,1220,1268,560
102126,26,Bulawayo,Bulawayo,,1021,21196,11574,9622,5134
150619,19,Matabeleland North,Tsholotsho,,1506,5752,3142,2610,1242
160203,3,Matabeleland South,Bulilima,,1602,6093,3301,2792,1286
160202,2,Matabeleland South,Bulilima,,1602,2617,1411,1206,591
160205,5,Matabeleland South,Bulilima,,1602,6015,3276,2739,1417
102112,12,Bulawayo,Bulawayo,,1021,26674,14059,12615,6789
150613,13,Matabeleland North,Tsholotsho,,1506,6168,3327,2841,1411
150716,16,Matabeleland North,Umguza,,1507,11719,4475,7244,2314
150709,9,Matabeleland North,Umguza,,1507,5626,2635,2991,1411
150214,14,Matabeleland North,Bubi,,1502,1380,616,764,362
150617,17,Matabeleland North,Tsholotsho,,1506,4533,2562,1971,959
150615,15,Matabeleland North,Tsholotsho,,1506,8132,4514,3618,1727
150712,12,Matabeleland North,Umguza,,1507,2140,1112,1028,436
150717,17,Matabeleland North,Umguza,,1507,761,346,415,191
150414,14,Matabeleland North,Lupane,,1504,3245,1695,1550,655
150415,15,Matabeleland North,Lupane,,1504,6171,3193,2978,1388
150514,14,Matabeleland North,Nkayi,,1505,3990,2137,1853,771
150416,16,Matabeleland North,Lupane,,1504,4143,2179,1964,783
150417,17,Matabeleland North,Lupane,,1504,4006,2087,1919,708
172115,15,Midlands,Gweru Urban,,1721,13580,7307,6273,3422
140410,10,Mashonaland West,Kariba,,1404,1564,802,762,349
140215,15,Mashonaland West,Hurungwe,,1402,6392,3240,3152,1381
160716,16,Matabeleland South,Umzingwane,,1607,3339,1692,1647,923
160717,17,Matabeleland South,Umzingwane,,1607,2930,1473,1457,1008
160715,15,Matabeleland South,Umzingwane,,1607,447,170,277,139
160703,3,Matabeleland South,Umzingwane,,1607,5347,2738,2609,1140
150701,1,Matabeleland North,Umguza,,1507,5549,2705,2844,1459
130306,6,Mashonaland East,Hwedza,,1303,6817,3559,3258,1726
130124,24,Mashonaland East,Chikomba,,1301,3126,1626,1500,833
160705,5,Matabeleland South,Umzingwane,,1607,4314,2325,1989,913
160704,4,Matabeleland South,Umzingwane,,1607,3987,2024,1963,884
150222,22,Matabeleland North,Bubi,,1502,739,324,415,256
130129,29,Mashonaland East,Chikomba,,1301,4953,2567,2386,1330
150708,8,Matabeleland North,Umguza,,1507,5198,2451,2747,1394
150707,7,Matabeleland North,Umguza,,1507,5373,2693,2680,1465
150211,11,Matabeleland North,Bubi,,1502,7416,3589,3827,2041
140210,10,Mashonaland West,Hurungwe,,1402,8670,4480,4190,2101
140218,18,Mashonaland West,Hurungwe,,1402,10721,5125,5596,2197
150212,12,Matabeleland North,Bubi,,1502,2754,1287,1467,624
160522,22,Matabeleland South,Insiza,,1605,5634,2820,2814,1221
140211,11,Mashonaland West,Hurungwe,,1402,16191,8366,7825,3537
150223,23,Matabeleland North,Bubi,,1502,3109,1331,1778,799
150215,15,Matabeleland North,Bubi,,1502,2495,1284,1211,557
150706,6,Matabeleland North,Umguza,,1507,2940,1531,1409,638
172212,12,Midlands,Kwekwe Urban,,1722,6349,3344,3005,1511
170530,30,Midlands,Kwekwe,,1705,6185,2925,3260,1504
140517,17,Mashonaland West,Makonde,,1405,4858,2465,2393,1088
140219,19,Mashonaland West,Hurungwe,,1402,9575,4637,4938,1924
150702,2,Matabeleland North,Umguza,,1507,12220,5328,6892,2775
160702,2,Matabeleland South,Umzingwane,,1607,3605,1909,1696,835
160719,19,Matabeleland South,Umzingwane,,1607,4245,1986,2259,1054
172214,14,Midlands,Kwekwe Urban,,1722,6435,3294,3141,1622
160514,14,Matabeleland South,Insiza,,1605,2541,1054,1487,794
160714,14,Matabeleland South,Umzingwane,,1607,3304,1545,1759,797
150705,5,Matabeleland North,Umguza,,1507,3940,1956,1984,808
172213,13,Midlands,Kwekwe Urban,,1722,3826,2019,1807,912
160518,18,Matabeleland South,Insiza,,1605,3335,1725,1610,645
160701,1,Matabeleland South,Umzingwane,,1607,3340,1681,1659,652
160718,18,Matabeleland South,Umzingwane,,1607,4675,2180,2495,1140
150704,4,Matabeleland North,Umguza,,1507,2996,1521,1475,616
170121,21,Midlands,Chirumhanzu,,1701,1824,977,847,464
180313,13,Masvingo,Chivi,,1803,3634,2019,1615,844
172811,11,Midlands,Shurugwi Town,,1728,2654,1380,1274,645
172805,5,Midlands,Shurugwi Town,,1728,1802,988,814,478
172810,10,Midlands,Shurugwi Town,,1728,1504,773,731,425
140206,6,Mashonaland West,Hurungwe,,1402,11862,5715,6147,2538
140615,15,Mashonaland West,Zvimba,,1406,13267,6623,6644,3265
172806,6,Midlands,Shurugwi Town,,1728,2177,1004,1173,539
180316,16,Masvingo,Chivi,,1803,7836,4179,3657,1685
180510,10,Masvingo,Masvingo,,1805,8247,4389,3858,1708
180310,10,Masvingo,Chivi,,1803,3901,2054,1847,856
182102,2,Masvingo,Masvingo Urban,,1821,6209,3324,2885,1740
180505,5,Masvingo,Masvingo,,1805,5307,2768,2539,1489
180305,5,Masvingo,Chivi,,1803,4019,2175,1844,880
180304,4,Masvingo,Chivi,,1803,4041,2216,1825,879
180509,9,Masvingo,Masvingo,,1805,6459,3326,3133,1248
180307,7,Masvingo,Chivi,,1803,3040,1634,1406,641
180306,6,Masvingo,Chivi,,1803,2272,1240,1032,521
172807,7,Midlands,Shurugwi Town,,1728,1181,576,605,274
180309,9,Masvingo,Chivi,,1803,4104,2239,1865,915
180312,12,Masvingo,Chivi,,1803,5240,2849,2391,1131
180311,11,Masvingo,Chivi,,1803,4466,2469,1997,996
180330,30,Masvingo,Chivi,,1803,4446,2472,1974,1168
180303,3,Masvingo,Chivi,,1803,5207,2716,2491,1111
170705,5,Midlands,Shurugwi,,1707,3313,1746,1567,709
170714,14,Midlands,Shurugwi,,1707,2743,1483,1260,679
170718,18,Midlands,Shurugwi,,1707,6334,2926,3408,1448
170109,9,Midlands,Chirumhanzu,,1701,5219,2844,2375,1320
170715,15,Midlands,Shurugwi,,1707,2992,1586,1406,696
172813,13,Midlands,Shurugwi Town,,1728,2269,987,1282,585
170719,19,Midlands,Shurugwi,,1707,4332,1979,2353,777
170720,20,Midlands,Shurugwi,,1707,2741,1365,1376,589
172804,4,Midlands,Shurugwi Town,,1728,1048,499,549,263
170710,10,Midlands,Shurugwi,,1707,6165,3285,2880,1471
170708,8,Midlands,Shurugwi,,1707,3594,1889,1705,767
170105,5,Midlands,Chirumhanzu,,1701,2775,1551,1224,694
170713,13,Midlands,Shurugwi,,1707,3635,1931,1704,891
172808,8,Midlands,Shurugwi Town,,1728,1695,871,824,433
170703,3,Midlands,Shurugwi,,1707,304,142,162,73
170723,23,Midlands,Shurugwi,,1707,1613,866,747,316
170104,4,Midlands,Chirumhanzu,,1701,2180,1190,990,566
172809,9,Midlands,Shurugwi Town,,1728,1018,524,494,267
170707,7,Midlands,Shurugwi,,1707,2215,1162,1053,523
170110,10,Midlands,Chirumhanzu,,1701,1170,609,561,299
170103,3,Midlands,Chirumhanzu,,1701,4255,2385,1870,1030
170107,7,Midlands,Chirumhanzu,,1701,2782,1468,1314,700
170721,21,Midlands,Shurugwi,,1707,5379,2771,2608,1143
170806,6,Midlands,Zvishavane,,1708,4352,2372,1980,966
170801,1,Midlands,Zvishavane,,1708,2060,1061,999,488
170802,2,Midlands,Zvishavane,,1708,3128,1652,1476,726
180302,2,Masvingo,Chivi,,1803,5940,3222,2718,1315
172503,3,Midlands,Zvishavane Urban,,1725,4700,2509,2191,1400
172507,7,Midlands,Zvishavane Urban,,1725,7113,3754,3359,1765
170807,7,Midlands,Zvishavane,,1708,3707,1985,1722,771
170805,5,Midlands,Zvishavane,,1708,2877,1346,1531,570
170813,13,Midlands,Zvishavane,,1708,4153,2139,2014,867
172802,2,Midlands,Shurugwi Town,,1728,1657,796,861,437
172509,9,Midlands,Zvishavane Urban,,1725,3804,1930,1874,1042
170123,23,Midlands,Chirumhanzu,,1701,3314,1818,1496,812
172504,4,Midlands,Zvishavane Urban,,1725,5474,2880,2594,1323
170125,25,Midlands,Chirumhanzu,,1701,3636,1976,1660,881
150306,6,Matabeleland North,Hwange,,1503,2865,1477,1388,711
150304,4,Matabeleland North,Hwange,,1503,3316,1708,1608,753
180435,35,Masvingo,Gutu,,1804,3219,1716,1503,827
180438,38,Masvingo,Gutu,,1804,1560,839,721,372
170711,11,Midlands,Shurugwi,,1707,5033,2710,2323,1117
170712,12,Midlands,Shurugwi,,1707,4156,2269,1887,995
170724,24,Midlands,Shurugwi,,1707,3403,1805,1598,785
170124,24,Midlands,Chirumhanzu,,1701,2043,1106,937,540
170114,14,Midlands,Chirumhanzu,,1701,2076,1117,959,575
172108,8,Midlands,Gweru Urban,,1721,11939,6328,5611,3303
170704,4,Midlands,Shurugwi,,1707,541,288,253,112
170706,6,Midlands,Shurugwi,,1707,1322,660,662,238
170722,22,Midlands,Shurugwi,,1707,502,238,264,100
180504,4,Masvingo,Masvingo,,1805,1037,560,477,243
170709,9,Midlands,Shurugwi,,1707,4643,2478,2165,1081
172116,16,Midlands,Gweru Urban,,1721,8940,4886,4054,2218
172114,14,Midlands,Gweru Urban,,1721,6655,3511,3144,1726
170803,3,Midlands,Zvishavane,,1708,2795,1444,1351,620
110207,7,Manicaland,Chimanimani,,1102,7292,3831,3461,1681
110217,17,Manicaland,Chimanimani,,1102,5532,2908,2624,1202
170808,8,Midlands,Zvishavane,,1708,2829,1532,1297,648
170804,4,Midlands,Zvishavane,,1708,3404,1845,1559,747
112303,3,Manicaland,Chipinge Urban,,1123,3275,1812,1463,881
112304,4,Manicaland,Chipinge Urban,,1123,3034,1631,1403,850
120313,13,Mashonaland Central,Guruve,,1203,6282,3029,3253,1366
180301,1,Masvingo,Chivi,,1803,5711,3063,2648,1204
170809,9,Midlands,Zvishavane,,1708,434,235,199,113
180422,22,Masvingo,Gutu,,1804,3670,1969,1701,872
120305,5,Mashonaland Central,Guruve,,1203,5547,2902,2645,1345
172506,6,Midlands,Zvishavane Urban,,1725,3397,1812,1585,831
170810,10,Midlands,Zvishavane,,1708,3660,1945,1715,746
170812,12,Midlands,Zvishavane,,1708,3665,1825,1840,750
170811,11,Midlands,Zvishavane,,1708,2999,1633,1366,651
172812,12,Midlands,Shurugwi Town,,1728,3277,1651,1626,781
172801,1,Midlands,Shurugwi Town,,1728,1051,505,546,320
172501,1,Midlands,Zvishavane Urban,,1725,2939,1573,1366,750
172505,5,Midlands,Zvishavane Urban,,1725,1621,876,745,424
172508,8,Midlands,Zvishavane Urban,,1725,9574,4942,4632,2705
172510,10,Midlands,Zvishavane Urban,,1725,4824,2492,2332,1352
172502,2,Midlands,Zvishavane Urban,,1725,1879,1032,847,476
172103,3,Midlands,Gweru Urban,,1721,2343,1211,1132,640
172102,2,Midlands,Gweru Urban,,1721,11539,5997,5542,2834
170108,8,Midlands,Chirumhanzu,,1701,3331,1844,1487,845
172803,3,Midlands,Shurugwi Town,,1728,1123,561,562,320
180704,4,Masvingo,Zaka,,1807,8539,4663,3876,1905
180705,5,Masvingo,Zaka,,1807,5371,2952,2419,1227
180105,5,Masvingo,Bikita,,1801,6559,3542,3017,1554
180710,10,Masvingo,Zaka,,1807,5614,3045,2569,1307
172117,17,Midlands,Gweru Urban,,1721,8300,4499,3801,2114
172106,6,Midlands,Gweru Urban,,1721,7175,3728,3447,1985
180703,3,Masvingo,Zaka,,1807,6010,3297,2713,1311
180707,7,Masvingo,Zaka,,1807,2848,1530,1318,620
172107,7,Midlands,Gweru Urban,,1721,7319,3954,3365,1959
120306,6,Mashonaland Central,Guruve,,1203,7388,3902,3486,1964
180106,6,Masvingo,Bikita,,1801,4224,2397,1827,975
180440,40,Masvingo,Gutu,,1804,2916,1616,1300,693
152211,11,Matabeleland North,Victoria Falls,,1522,13230,6920,6310,3755
120310,10,Mashonaland Central,Guruve,,1203,4468,2310,2158,1050
120311,11,Mashonaland Central,Guruve,,1203,6581,3524,3057,1613
120308,8,Mashonaland Central,Guruve,,1203,4400,2283,2117,1011
180517,17,Masvingo,Masvingo,,1805,6893,3735,3158,1577
180520,20,Masvingo,Masvingo,,1805,4592,2564,2028,1003
180719,19,Masvingo,Zaka,,1807,10286,5846,4440,2568
180722,22,Masvingo,Zaka,,1807,3572,1921,1651,785
180716,16,Masvingo,Zaka,,1807,4702,2641,2061,1059
180713,13,Masvingo,Zaka,,1807,4267,2298,1969,965
172101,1,Midlands,Gweru Urban,,1721,7037,3784,3253,1794
180518,18,Masvingo,Masvingo,,1805,7273,3939,3334,1635
182107,7,Masvingo,Masvingo Urban,,1821,19131,10505,8626,5350
180514,14,Masvingo,Masvingo,,1805,5510,2957,2553,1237
180431,31,Masvingo,Gutu,,1804,4764,2571,2193,1196
180430,30,Masvingo,Gutu,,1804,3528,1907,1621,851
180718,18,Masvingo,Zaka,,1807,5728,3130,2598,1183
180516,16,Masvingo,Masvingo,,1805,8357,4605,3752,1815
180515,15,Masvingo,Masvingo,,1805,5643,3079,2564,1231
180114,14,Masvingo,Bikita,,1801,6437,3533,2904,1488
180107,7,Masvingo,Bikita,,1801,5058,2709,2349,1210
180108,8,Masvingo,Bikita,,1801,6125,3407,2718,1456
180104,4,Masvingo,Bikita,,1801,5242,2932,2310,1260
180129,29,Masvingo,Bikita,,1801,1501,752,749,324
180128,28,Masvingo,Bikita,,1801,1738,895,843,343
180110,10,Masvingo,Bikita,,1801,5274,2882,2392,1215
180702,2,Masvingo,Zaka,,1807,4849,2641,2208,1123
180715,15,Masvingo,Zaka,,1807,8443,4549,3894,1866
180411,11,Masvingo,Gutu,,1804,6161,3375,2786,1557
180415,15,Masvingo,Gutu,,1804,11118,6027,5091,2597
120312,12,Mashonaland Central,Guruve,,1203,6400,3306,3094,1556
180121,21,Masvingo,Bikita,,1801,4174,2324,1850,976
180118,18,Masvingo,Bikita,,1801,4754,2532,2222,1105
180111,11,Masvingo,Bikita,,1801,7490,4009,3481,1740
180130,30,Masvingo,Bikita,,1801,633,269,364,211
180112,12,Masvingo,Bikita,,1801,4234,2283,1951,977
180122,22,Masvingo,Bikita,,1801,5777,3132,2645,1370
180508,8,Masvingo,Masvingo,,1805,8943,4558,4385,1959
180425,25,Masvingo,Gutu,,1804,4130,2321,1809,1022
180109,9,Masvingo,Bikita,,1801,6968,3786,3182,1638
180113,13,Masvingo,Bikita,,1801,10681,5917,4764,2622
180132,32,Masvingo,Bikita,,1801,4088,2276,1812,968
180116,16,Masvingo,Bikita,,1801,8482,4688,3794,1946
180117,17,Masvingo,Bikita,,1801,4736,2623,2113,1156
180426,26,Masvingo,Gutu,,1804,4529,2460,2069,1085
180428,28,Masvingo,Gutu,,1804,4683,2600,2083,1086
180408,8,Masvingo,Gutu,,1804,8803,4796,4007,2057
180434,34,Masvingo,Gutu,,1804,6973,3337,3636,1814
152204,4,Matabeleland North,Victoria Falls,,1522,2257,1145,1112,592
152205,5,Matabeleland North,Victoria Falls,,1522,1663,873,790,476
180414,14,Masvingo,Gutu,,1804,2773,1533,1240,644
152210,10,Matabeleland North,Victoria Falls,,1522,2832,1483,1349,767
120309,9,Mashonaland Central,Guruve,,1203,5452,2900,2552,1266
180417,17,Masvingo,Gutu,,1804,3011,1644,1367,757
180436,36,Masvingo,Gutu,,1804,4616,2482,2134,1086
180433,33,Masvingo,Gutu,,1804,1415,711,704,370
180418,18,Masvingo,Gutu,,1804,4725,2466,2259,1064
172118,18,Midlands,Gweru Urban,,1721,7483,4001,3482,1942
172109,9,Midlands,Gweru Urban,,1721,7544,4003,3541,2013
180420,20,Masvingo,Gutu,,1804,1515,733,782,328
180437,37,Masvingo,Gutu,,1804,5915,3181,2734,1375
180502,2,Masvingo,Masvingo,,1805,6638,3647,2991,1660
180427,27,Masvingo,Gutu,,1804,5214,2853,2361,1201
180424,24,Masvingo,Gutu,,1804,5088,2805,2283,1232
172111,11,Midlands,Gweru Urban,,1721,6939,3776,3163,1846
172112,12,Midlands,Gweru Urban,,1721,7700,4224,3476,1889
172113,13,Midlands,Gweru Urban,,1721,9357,5020,4337,2436
180423,23,Masvingo,Gutu,,1804,7570,4109,3461,1745
180131,31,Masvingo,Bikita,,1801,5725,2915,2810,1268
180429,29,Masvingo,Gutu,,1804,3638,1901,1737,796
180115,15,Masvingo,Bikita,,1801,6662,3674,2988,1567
180119,19,Masvingo,Bikita,,1801,4510,2448,2062,1082
180123,23,Masvingo,Bikita,,1801,286,139,147,63
180441,41,Masvingo,Gutu,,1804,3817,2065,1752,911
180501,1,Masvingo,Masvingo,,1805,5920,3195,2725,1459
110215,15,Manicaland,Chimanimani,,1102,5031,2557,2474,1451
110212,12,Manicaland,Chimanimani,,1102,5174,2343,2831,1642
110208,8,Manicaland,Chimanimani,,1102,8750,4665,4085,2066
110220,20,Manicaland,Chimanimani,,1102,7199,3895,3304,1715
180532,32,Masvingo,Masvingo,,1805,7923,3869,4054,1777
180513,13,Masvingo,Masvingo,,1805,8550,4695,3855,1856
180127,27,Masvingo,Bikita,,1801,350,122,228,169
180701,1,Masvingo,Zaka,,1807,3561,1927,1634,765
180714,14,Masvingo,Zaka,,1807,4658,2552,2106,1048
180709,9,Masvingo,Zaka,,1807,5540,3002,2538,1251
180712,12,Masvingo,Zaka,,1807,5466,2947,2519,1235
180711,11,Masvingo,Zaka,,1807,6126,3407,2719,1316
180706,6,Masvingo,Zaka,,1807,4571,2466,2105,1041
180733,33,Masvingo,Zaka,,1807,4554,2508,2046,1001
180708,8,Masvingo,Zaka,,1807,7300,4006,3294,1685
180421,21,Masvingo,Gutu,,1804,4053,2221,1832,1071
180419,19,Masvingo,Gutu,,1804,3996,2098,1898,957
180420,20,Masvingo,Gutu,,1804,1515,733,782,328
180413,13,Masvingo,Gutu,,1804,7508,4086,3422,1872
110213,13,Manicaland,Chimanimani,,1102,11042,5738,5304,2423
110219,19,Manicaland,Chimanimani,,1102,2748,1510,1238,662
110129,29,Manicaland,Buhera,,1101,9554,5192,4362,2146
110307,7,Manicaland,Chipinge,,1103,6040,3083,2957,1482
110306,6,Manicaland,Chipinge,,1103,12872,6556,6316,2783
110302,2,Manicaland,Chipinge,,1103,6641,3689,2952,1526
110210,10,Manicaland,Chimanimani,,1102,2650,1465,1185,634
110221,21,Manicaland,Chimanimani,,1102,6596,3493,3103,1577
110218,18,Manicaland,Chimanimani,,1102,2483,1291,1192,624
110222,22,Manicaland,Chimanimani,,1102,9952,5333,4619,2379
110309,9,Manicaland,Chipinge,,1103,5156,2690,2466,1054
110125,25,Manicaland,Buhera,,1101,10511,5563,4948,2334
110204,4,Manicaland,Chimanimani,,1102,8393,4450,3943,2043
110128,28,Manicaland,Buhera,,1101,10396,5604,4792,2313
110205,5,Manicaland,Chimanimani,,1102,7044,3341,3703,1708
112308,8,Manicaland,Chipinge Urban,,1123,3463,1793,1670,873
112301,1,Manicaland,Chipinge Urban,,1123,2520,1381,1139,672
112307,7,Manicaland,Chipinge Urban,,1123,3843,2091,1752,959
110311,11,Manicaland,Chipinge,,1103,3257,1712,1545,751
110301,1,Manicaland,Chipinge,,1103,7030,3840,3190,1679
110216,16,Manicaland,Chimanimani,,1102,12967,6491,6476,3184
110206,6,Manicaland,Chimanimani,,1102,2547,1398,1149,648
110203,3,Manicaland,Chimanimani,,1102,5488,2934,2554,1322
110312,12,Manicaland,Chipinge,,1103,5391,2813,2578,1501
110318,18,Manicaland,Chipinge,,1103,11052,5976,5076,2258
110313,13,Manicaland,Chipinge,,1103,6220,3234,2986,1334
110211,11,Manicaland,Chimanimani,,1102,1567,785,782,418
110133,33,Manicaland,Buhera,,1101,9594,5157,4437,2188
110209,9,Manicaland,Chimanimani,,1102,1709,896,813,420
110130,30,Manicaland,Buhera,,1101,4588,2539,2049,1071
110314,14,Manicaland,Chipinge,,1103,4658,2548,2110,960
112306,6,Manicaland,Chipinge Urban,,1123,2580,1409,1171,680
110214,14,Manicaland,Chimanimani,,1102,3510,1659,1851,1140
112305,5,Manicaland,Chipinge Urban,,1123,2587,1380,1207,732
110305,5,Manicaland,Chipinge,,1103,11808,5644,6164,2735
110304,4,Manicaland,Chipinge,,1103,6637,3715,2922,1529
110303,3,Manicaland,Chipinge,,1103,11078,6226,4852,2560
110308,8,Manicaland,Chipinge,,1103,14259,7084,7175,3616
110223,23,Manicaland,Chimanimani,,1102,6959,3953,3006,1687
112302,2,Manicaland,Chipinge Urban,,1123,4373,2387,1986,1210
150425,25,Matabeleland North,Lupane,,1504,1538,777,761,353
150217,17,Matabeleland North,Bubi,,1502,2858,1472,1386,588
150407,7,Matabeleland North,Lupane,,1504,2013,1072,941,360
150508,8,Matabeleland North,Nkayi,,1505,2364,1223,1141,426
150512,12,Matabeleland North,Nkayi,,1505,2678,1376,1302,492
150513,13,Matabeleland North,Nkayi,,1505,4510,2423,2087,843
150420,20,Matabeleland North,Lupane,,1504,3971,2079,1892,750
150418,18,Matabeleland North,Lupane,,1504,3324,1763,1561,615
150525,25,Matabeleland North,Nkayi,,1505,3286,1651,1635,604
150524,24,Matabeleland North,Nkayi,,1505,6842,3622,3220,1285
150604,4,Matabeleland North,Tsholotsho,,1506,2834,1457,1377,563
150426,26,Matabeleland North,Lupane,,1504,869,429,440,179
150605,5,Matabeleland North,Tsholotsho,,1506,5182,2748,2434,1108
150203,3,Matabeleland North,Bubi,,1502,3608,1907,1701,748
172303,3,Midlands,Redcliff,,1723,2702,1379,1323,692
172301,1,Midlands,Redcliff,,1723,2405,1251,1154,656
172302,2,Midlands,Redcliff,,1723,3483,1745,1738,954
150218,18,Matabeleland North,Bubi,,1502,2138,1102,1036,438
150423,23,Matabeleland North,Lupane,,1504,3162,1663,1499,603
150421,21,Matabeleland North,Lupane,,1504,4600,2418,2182,833
150207,7,Matabeleland North,Bubi,,1502,3302,1736,1566,780
150204,4,Matabeleland North,Bubi,,1502,3760,2016,1744,751
150510,10,Matabeleland North,Nkayi,,1505,1926,1001,925,355
150511,11,Matabeleland North,Nkayi,,1505,3612,1845,1767,742
150502,2,Matabeleland North,Nkayi,,1505,2791,1480,1311,566
170315,15,Midlands,Gokwe South,,1703,13292,6953,6339,2698
150501,1,Matabeleland North,Nkayi,,1505,2953,1503,1450,553
170532,32,Midlands,Kwekwe,,1705,3675,1853,1822,823
170512,12,Midlands,Kwekwe,,1705,5326,2782,2544,1081
170513,13,Midlands,Kwekwe,,1705,6428,3360,3068,1282
170510,10,Midlands,Kwekwe,,1705,5898,3057,2841,1297
170505,5,Midlands,Kwekwe,,1705,3349,1620,1729,649
170515,15,Midlands,Kwekwe,,1705,6906,3443,3463,1450
170511,11,Midlands,Kwekwe,,1705,6686,3508,3178,1367
170409,9,Midlands,Gweru,,1704,5455,2653,2802,1258
170412,12,Midlands,Gweru,,1704,4329,2328,2001,987
170411,11,Midlands,Gweru,,1704,3575,1965,1610,793
172306,6,Midlands,Redcliff,,1723,9583,5004,4579,2493
150422,22,Matabeleland North,Lupane,,1504,7174,3723,3451,1457
150216,16,Matabeleland North,Bubi,,1502,1966,1002,964,398
150410,10,Matabeleland North,Lupane,,1504,5032,2655,2377,899
170521,21,Midlands,Kwekwe,,1705,9682,5035,4647,2045
170522,22,Midlands,Kwekwe,,1705,9682,4894,4788,1933
170526,26,Midlands,Kwekwe,,1705,1888,957,931,387
170529,29,Midlands,Kwekwe,,1705,2831,1427,1404,579
170518,18,Midlands,Kwekwe,,1705,2195,1101,1094,587
170520,20,Midlands,Kwekwe,,1705,5529,2799,2730,1282
170519,19,Midlands,Kwekwe,,1705,2550,1318,1232,618
170528,28,Midlands,Kwekwe,,1705,2026,1034,992,397
170527,27,Midlands,Kwekwe,,1705,4998,2550,2448,1002
150504,4,Matabeleland North,Nkayi,,1505,3709,1885,1824,765
150503,3,Matabeleland North,Nkayi,,1505,3290,1719,1571,690
150506,6,Matabeleland North,Nkayi,,1505,3609,1854,1755,746
170525,25,Midlands,Kwekwe,,1705,5099,2645,2454,1096
170523,23,Midlands,Kwekwe,,1705,1525,803,722,292
170533,33,Midlands,Kwekwe,,1705,3604,1826,1778,719
150522,22,Matabeleland North,Nkayi,,1505,3535,1797,1738,622
172307,7,Midlands,Redcliff,,1723,1850,987,863,494
170404,4,Midlands,Gweru,,1704,3417,1806,1611,751
170407,7,Midlands,Gweru,,1704,4468,2369,2099,1020
172207,7,Midlands,Kwekwe Urban,,1722,4598,2390,2208,1122
152203,3,Matabeleland North,Victoria Falls,,1522,1052,564,488,253
172209,9,Midlands,Kwekwe Urban,,1722,3762,1971,1791,939
170406,6,Midlands,Gweru,,1704,5002,2694,2308,1064
170408,8,Midlands,Gweru,,1704,8940,4832,4108,1863
150530,30,Matabeleland North,Nkayi,,1505,1955,1036,919,391
150519,19,Matabeleland North,Nkayi,,1505,3469,1783,1686,715
150518,18,Matabeleland North,Nkayi,,1505,2746,1426,1320,582
150529,29,Matabeleland North,Nkayi,,1505,4423,2273,2150,848
150520,20,Matabeleland North,Nkayi,,1505,4172,2128,2044,772
150517,17,Matabeleland North,Nkayi,,1505,2689,1456,1233,525
172110,10,Midlands,Gweru Urban,,1721,11906,6288,5618,3045
170502,2,Midlands,Kwekwe,,1705,4623,2152,2471,1348
142704,4,Mashonaland West,Mhondoro-Ngezi,,1427,5076,2716,2360,1241
142703,3,Mashonaland West,Mhondoro-Ngezi,,1427,2519,1329,1190,637
142711,11,Mashonaland West,Mhondoro-Ngezi,,1427,18039,7798,10241,4492
142705,5,Mashonaland West,Mhondoro-Ngezi,,1427,6220,3275,2945,1531
170403,3,Midlands,Gweru,,1704,7882,4324,3558,1651
170524,24,Midlands,Kwekwe,,1705,6428,3297,3131,1340
170517,17,Midlands,Kwekwe,,1705,7811,4087,3724,1535
170514,14,Midlands,Kwekwe,,1705,6488,3348,3140,1316
150505,5,Matabeleland North,Nkayi,,1505,2139,1121,1018,434
142702,2,Mashonaland West,Mhondoro-Ngezi,,1427,2104,1112,992,506
142708,8,Mashonaland West,Mhondoro-Ngezi,,1427,2938,1524,1414,681
142706,6,Mashonaland West,Mhondoro-Ngezi,,1427,5285,2772,2513,1292
142707,7,Mashonaland West,Mhondoro-Ngezi,,1427,1688,897,791,406
130821,21,Mashonaland East,Seke,,1308,1301,665,636,292
142709,9,Mashonaland West,Mhondoro-Ngezi,,1427,4965,2453,2512,1009
130107,7,Mashonaland East,Chikomba,,1301,8169,3888,4281,1886
170119,19,Midlands,Chirumhanzu,,1701,3871,1944,1927,836
170413,13,Midlands,Gweru,,1704,1886,1004,882,413
170116,16,Midlands,Chirumhanzu,,1701,1067,484,583,332
170414,14,Midlands,Gweru,,1704,8367,3553,4814,1917
170113,13,Midlands,Chirumhanzu,,1701,1292,678,614,365
172204,4,Midlands,Kwekwe Urban,,1722,5298,2835,2463,1310
172203,3,Midlands,Kwekwe Urban,,1722,10335,5412,4923,2545
172211,11,Midlands,Kwekwe Urban,,1722,12077,6274,5803,2879
172202,2,Midlands,Kwekwe Urban,,1722,13147,6822,6325,3431
172208,8,Midlands,Kwekwe Urban,,1722,5475,2814,2661,1419
170112,12,Midlands,Chirumhanzu,,1701,4858,2310,2548,1121
170410,10,Midlands,Gweru,,1704,5182,2821,2361,1235
170122,22,Midlands,Chirumhanzu,,1701,4326,2163,2163,1019
172206,6,Midlands,Kwekwe Urban,,1722,3800,1862,1938,964
172205,5,Midlands,Kwekwe Urban,,1722,9973,5287,4686,2333
172210,10,Midlands,Kwekwe Urban,,1722,4477,2341,2136,1073
130110,10,Mashonaland East,Chikomba,,1301,2501,1380,1121,730
130106,6,Mashonaland East,Chikomba,,1301,2981,1637,1344,760
180410,10,Masvingo,Gutu,,1804,6197,3388,2809,1544
110106,6,Manicaland,Buhera,,1101,8890,4784,4106,2093
130109,9,Mashonaland East,Chikomba,,1301,5196,2762,2434,1426
130104,4,Mashonaland East,Chikomba,,1301,2292,1148,1144,458
180404,4,Masvingo,Gutu,,1804,2503,1271,1232,540
112111,11,Manicaland,Mutare Urban,,1121,10052,5400,4652,2613
112105,5,Manicaland,Mutare Urban,,1121,8954,4664,4290,2262
112101,1,Manicaland,Mutare Urban,,1121,8107,4037,4070,2250
180402,2,Masvingo,Gutu,,1804,3407,1848,1559,828
110102,2,Manicaland,Buhera,,1101,4415,2305,2110,1083
110104,4,Manicaland,Buhera,,1101,6378,3482,2896,1524
110113,13,Manicaland,Buhera,,1101,6915,3573,3342,1608
110131,31,Manicaland,Buhera,,1101,5577,2970,2607,1369
130305,5,Mashonaland East,Hwedza,,1303,6754,3529,3225,1655
112116,16,Manicaland,Mutare Urban,,1121,22169,11765,10404,5629
112114,14,Manicaland,Mutare Urban,,1121,18774,9918,8856,4814
110534,34,Manicaland,Mutare,,1105,14567,7093,7474,2966
110411,11,Manicaland,Makoni,,1104,7269,3477,3792,1748
110416,16,Manicaland,Makoni,,1104,13344,6855,6489,3062
110430,30,Manicaland,Makoni,,1104,6772,3521,3251,1460
110417,17,Manicaland,Makoni,,1104,9124,4394,4730,2135
110423,23,Manicaland,Makoni,,1104,8712,4516,4196,2081
110422,22,Manicaland,Makoni,,1104,3478,1885,1593,866
110615,15,Manicaland,Mutasa,,1106,3307,1765,1542,889
110617,17,Manicaland,Mutasa,,1106,10222,5397,4825,2487
110619,19,Manicaland,Mutasa,,1106,6738,3692,3046,1702
130301,1,Mashonaland East,Hwedza,,1303,4797,2195,2602,1144
130102,2,Mashonaland East,Chikomba,,1301,1915,841,1074,452
110627,27,Manicaland,Mutasa,,1106,1467,634,833,427
110608,8,Manicaland,Mutasa,,1106,6381,3460,2921,1596
110616,16,Manicaland,Mutasa,,1106,3050,1630,1420,778
110426,26,Manicaland,Makoni,,1104,9136,4826,4310,2252
150309,9,Matabeleland North,Hwange,,1503,1514,784,730,377
152101,1,Matabeleland North,Hwange Urban,,1521,1485,719,766,365
142101,1,Mashonaland West,Chinhoyi,,1421,1913,1020,893,524
142102,2,Mashonaland West,Chinhoyi,,1421,3823,2009,1814,979
110414,14,Manicaland,Makoni,,1104,5583,2948,2635,1247
130303,3,Mashonaland East,Hwedza,,1303,2965,1458,1507,626
130302,2,Mashonaland East,Hwedza,,1303,8094,3795,4299,2028
130407,7,Mashonaland East,Marondera,,1304,5173,2442,2731,1290
130315,15,Mashonaland East,Hwedza,,1303,3663,1992,1671,1025
130309,9,Mashonaland East,Hwedza,,1303,6657,3493,3164,1553
152103,3,Matabeleland North,Hwange Urban,,1521,553,283,270,114
152106,6,Matabeleland North,Hwange Urban,,1521,2972,1539,1433,809
130304,4,Mashonaland East,Hwedza,,1303,3195,1574,1621,723
130103,3,Mashonaland East,Chikomba,,1301,1911,938,973,418
130308,8,Mashonaland East,Hwedza,,1303,6360,3339,3021,1567
130307,7,Mashonaland East,Hwedza,,1303,6683,3532,3151,1632
110424,24,Manicaland,Makoni,,1104,6159,3286,2873,1502
130123,23,Mashonaland East,Chikomba,,1301,4630,2501,2129,1192
130311,11,Mashonaland East,Hwedza,,1303,3513,1878,1635,891
130105,5,Mashonaland East,Chikomba,,1301,3554,1897,1657,892
130125,25,Mashonaland East,Chikomba,,1301,7193,3910,3283,1872
130122,22,Mashonaland East,Chikomba,,1301,3396,1790,1606,864
130128,28,Mashonaland East,Chikomba,,1301,3454,1851,1603,891
130130,30,Mashonaland East,Chikomba,,1301,3783,2023,1760,893
130121,21,Mashonaland East,Chikomba,,1301,2830,1494,1336,739
130117,17,Mashonaland East,Chikomba,,1301,6659,3595,3064,1725
130127,27,Mashonaland East,Chikomba,,1301,6032,3216,2816,1543
110108,8,Manicaland,Buhera,,1101,4955,2643,2312,1215
130118,18,Mashonaland East,Chikomba,,1301,3055,1643,1412,786
130116,16,Mashonaland East,Chikomba,,1301,6015,3297,2718,1530
130120,20,Mashonaland East,Chikomba,,1301,4821,2557,2264,1269
130126,26,Mashonaland East,Chikomba,,1301,4232,2229,2003,1092
130119,19,Mashonaland East,Chikomba,,1301,3208,1738,1470,805
130114,14,Mashonaland East,Chikomba,,1301,1790,898,892,394
130112,12,Mashonaland East,Chikomba,,1301,2246,1222,1024,660
130111,11,Mashonaland East,Chikomba,,1301,2264,1275,989,660
110110,10,Manicaland,Buhera,,1101,5922,3231,2691,1859
110103,3,Manicaland,Buhera,,1101,4394,2374,2020,1047
110109,9,Manicaland,Buhera,,1101,5344,2830,2514,1254
110101,1,Manicaland,Buhera,,1101,4829,2659,2170,1156
110111,11,Manicaland,Buhera,,1101,6943,3752,3191,1482
110105,5,Manicaland,Buhera,,1101,8597,4479,4118,2151
152111,11,Matabeleland North,Hwange Urban,,1521,3622,1747,1875,995
152113,13,Matabeleland North,Hwange Urban,,1521,0,0,0,0
152114,14,Matabeleland North,Hwange Urban,,1521,3907,2001,1906,1016
152112,12,Matabeleland North,Hwange Urban,,1521,2258,1144,1114,483
110117,17,Manicaland,Buhera,,1101,4225,2312,1913,1000
110116,16,Manicaland,Buhera,,1101,5433,2805,2628,1302
110503,3,Manicaland,Mutare,,1105,12610,6261,6349,2941
112113,13,Manicaland,Mutare Urban,,1121,2905,1376,1529,655
170316,16,Midlands,Gokwe South,,1703,10053,5127,4926,2041
172906,6,Midlands,Gokwe South Urban,,1729,2394,1263,1131,553
110114,14,Manicaland,Buhera,,1101,14342,7928,6414,3402
110531,31,Manicaland,Mutare,,1105,2567,1284,1283,715
110502,2,Manicaland,Mutare,,1105,10705,5304,5401,2167
112112,12,Manicaland,Mutare Urban,,1121,13744,7335,6409,3229
172903,3,Midlands,Gokwe South Urban,,1729,4405,2370,2035,1036
172901,1,Midlands,Gokwe South Urban,,1729,3084,1732,1352,797
110115,15,Manicaland,Buhera,,1101,9970,5448,4522,2354
152105,5,Matabeleland North,Hwange Urban,,1521,1958,1045,913,764
150313,13,Matabeleland North,Hwange,,1503,592,302,290,128
150320,20,Matabeleland North,Hwange,,1503,5704,2705,2999,1154
110107,7,Manicaland,Buhera,,1101,5250,2825,2425,1196
112206,6,Manicaland,Rusape,,1122,6030,3201,2829,1675
110610,10,Manicaland,Mutasa,,1106,3721,2012,1709,962
170304,4,Midlands,Gokwe South,,1703,8195,4298,3897,1653
170322,22,Midlands,Gokwe South,,1703,7269,3716,3553,1525
110618,18,Manicaland,Mutasa,,1106,2659,1175,1484,864
110418,18,Manicaland,Makoni,,1104,6228,3189,3039,1424
110501,1,Manicaland,Mutare,,1105,10704,5130,5574,2385
110626,26,Manicaland,Mutasa,,1106,5599,2820,2779,1319
110620,20,Manicaland,Mutasa,,1106,4325,2304,2021,1073
110624,24,Manicaland,Mutasa,,1106,4456,2398,2058,1087
110623,23,Manicaland,Mutasa,,1106,7178,3556,3622,1591
110621,21,Manicaland,Mutasa,,1106,9237,4564,4673,2377
110625,25,Manicaland,Mutasa,,1106,4212,2003,2209,1248
110622,22,Manicaland,Mutasa,,1106,3560,1713,1847,992
110535,35,Manicaland,Mutare,,1105,6493,3402,3091,1522
110505,5,Manicaland,Mutare,,1105,3821,1990,1831,880
112115,15,Manicaland,Mutare Urban,,1121,9700,5321,4379,2393
110533,33,Manicaland,Mutare,,1105,7348,3544,3804,2105
110510,10,Manicaland,Mutare,,1105,8905,4676,4229,1833
110511,11,Manicaland,Mutare,,1105,7478,3965,3513,1671
110512,12,Manicaland,Mutare,,1105,6592,3528,3064,1469
110516,16,Manicaland,Mutare,,1105,15414,8616,6798,3585
110523,23,Manicaland,Mutare,,1105,6692,3566,3126,1455
110513,13,Manicaland,Mutare,,1105,4959,2529,2430,1088
112103,3,Manicaland,Mutare Urban,,1121,7874,4075,3799,1930
170301,1,Midlands,Gokwe South,,1703,10588,5436,5152,2231
170321,21,Midlands,Gokwe South,,1703,9872,5084,4788,2106
110520,20,Manicaland,Mutare,,1105,4440,2375,2065,1031
110517,17,Manicaland,Mutare,,1105,6800,3719,3081,1576
110518,18,Manicaland,Mutare,,1105,6813,3645,3168,1547
110536,36,Manicaland,Mutare,,1105,4748,2494,2254,1050
112102,2,Manicaland,Mutare Urban,,1121,4804,2384,2420,1445
112104,4,Manicaland,Mutare Urban,,1121,7463,3789,3674,2019
112108,8,Manicaland,Mutare Urban,,1121,6188,3379,2809,1555
112109,9,Manicaland,Mutare Urban,,1121,7947,4269,3678,1997
110526,26,Manicaland,Mutare,,1105,2905,1527,1378,657
112118,18,Manicaland,Mutare Urban,,1121,12929,6943,5986,3235
170329,29,Midlands,Gokwe South,,1703,6932,3647,3285,1391
170303,3,Midlands,Gokwe South,,1703,3446,1872,1574,691
110527,27,Manicaland,Mutare,,1105,4383,2377,2006,1076
110504,4,Manicaland,Mutare,,1105,3936,2107,1829,922
112110,10,Manicaland,Mutare Urban,,1121,3379,1734,1645,839
112119,19,Manicaland,Mutare Urban,,1121,2051,1058,993,485
150403,3,Matabeleland North,Lupane,,1504,4720,2549,2171,923
172905,5,Midlands,Gokwe South Urban,,1729,7666,4245,3421,2080
110508,8,Manicaland,Mutare,,1105,2269,1194,1075,493
110532,32,Manicaland,Mutare,,1105,5637,3143,2494,1321
172904,4,Midlands,Gokwe South Urban,,1729,2233,1197,1036,637
172902,2,Midlands,Gokwe South Urban,,1729,4354,2421,1933,1292
170313,13,Midlands,Gokwe South,,1703,13357,6915,6442,2632
110515,15,Manicaland,Mutare,,1105,13694,7326,6368,3013
110514,14,Manicaland,Mutare,,1105,4749,2453,2296,1042
110521,21,Manicaland,Mutare,,1105,4826,2677,2149,1114
112205,5,Manicaland,Rusape,,1122,2144,1149,995,547
112202,2,Manicaland,Rusape,,1122,1433,779,654,410
112203,3,Manicaland,Rusape,,1122,1402,728,674,388
110429,29,Manicaland,Makoni,,1104,3542,1898,1644,869
142812,12,Mashonaland West,Sanyati,,1428,6763,3480,3283,1474
142810,10,Mashonaland West,Sanyati,,1428,5431,2858,2573,1216
142807,7,Mashonaland West,Sanyati,,1428,1952,996,956,457
142808,8,Mashonaland West,Sanyati,,1428,2516,1362,1154,594
142806,6,Mashonaland West,Sanyati,,1428,3738,1914,1824,826
142809,9,Mashonaland West,Sanyati,,1428,2556,1265,1291,581
142803,3,Mashonaland West,Sanyati,,1428,26478,12575,13903,6039
142805,5,Mashonaland West,Sanyati,,1428,11135,5607,5528,2254
170333,33,Midlands,Gokwe South,,1703,5100,2547,2553,1119
170323,23,Midlands,Gokwe South,,1703,14345,7340,7005,3083
142811,11,Mashonaland West,Sanyati,,1428,6173,3158,3015,1444
170226,26,Midlands,Gokwe North,,1702,2676,1347,1329,558
132101,1,Mashonaland East,Marondera Urban,,1321,3410,1754,1656,957
132102,2,Mashonaland East,Marondera Urban,,1321,4446,2385,2061,1222
110427,27,Manicaland,Makoni,,1104,8728,4664,4064,2065
152208,8,Matabeleland North,Victoria Falls,,1522,1809,955,854,545
152206,6,Matabeleland North,Victoria Falls,,1522,1341,731,610,370
152207,7,Matabeleland North,Victoria Falls,,1522,1839,983,856,500
152209,9,Matabeleland North,Victoria Falls,,1522,3644,1924,1720,1018
152201,1,Matabeleland North,Victoria Falls,,1522,1071,556,515,327
152202,2,Matabeleland North,Victoria Falls,,1522,2972,1370,1602,506
150303,3,Matabeleland North,Hwange,,1503,3712,1875,1837,885
150302,2,Matabeleland North,Hwange,,1503,4209,2087,2122,1037
142505,5,Mashonaland West,Norton,,1425,2525,1310,1215,644
142508,8,Mashonaland West,Norton,,1425,3789,1998,1791,926
150305,5,Matabeleland North,Hwange,,1503,2387,1180,1207,580
152107,7,Matabeleland North,Hwange Urban,,1521,697,265,432,149
150108,8,Matabeleland North,Binga,,1501,3786,2051,1735,1013
150107,7,Matabeleland North,Binga,,1501,5158,2860,2298,1231
150110,10,Matabeleland North,Binga,,1501,3853,2223,1630,975
150109,9,Matabeleland North,Binga,,1501,5461,3031,2430,1471
152115,15,Matabeleland North,Hwange Urban,,1521,5649,2789,2860,1483
150116,16,Matabeleland North,Binga,,1501,9437,5049,4388,2110
150118,18,Matabeleland North,Binga,,1501,5217,2751,2466,1135
150125,25,Matabeleland North,Binga,,1501,3963,2191,1772,879
150312,12,Matabeleland North,Hwange,,1503,2159,1141,1018,504
152110,10,Matabeleland North,Hwange Urban,,1521,1986,999,987,518
142507,7,Mashonaland West,Norton,,1425,4258,2229,2029,1060
142513,13,Mashonaland West,Norton,,1425,8083,4267,3816,1998
150314,14,Matabeleland North,Hwange,,1503,3838,2040,1798,832
142509,9,Mashonaland West,Norton,,1425,3727,1910,1817,944
140316,16,Mashonaland West,Kadoma Urban,,1403,5830,2948,2882,1411
150120,20,Matabeleland North,Binga,,1501,4131,2261,1870,815
150112,12,Matabeleland North,Binga,,1501,3250,1824,1426,758
170308,8,Midlands,Gokwe South,,1703,8977,4640,4337,1867
140512,12,Mashonaland West,Makonde,,1405,1797,872,925,370
140612,12,Mashonaland West,Zvimba,,1406,3616,1951,1665,853
140514,14,Mashonaland West,Makonde,,1405,4816,2412,2404,1101
140610,10,Mashonaland West,Zvimba,,1406,2286,1206,1080,540
140611,11,Mashonaland West,Zvimba,,1406,3585,1875,1710,842
170230,30,Midlands,Gokwe North,,1702,6536,3434,3102,1379
170201,1,Midlands,Gokwe North,,1702,6305,3338,2967,1308
170307,7,Midlands,Gokwe South,,1703,6354,3319,3035,1342
170310,10,Midlands,Gokwe South,,1703,11962,6371,5591,2445
142818,18,Mashonaland West,Sanyati,,1428,4337,2245,2092,1281
170507,7,Midlands,Kwekwe,,1705,6128,3177,2951,1368
170207,7,Midlands,Gokwe North,,1702,8451,4285,4166,1712
170233,33,Midlands,Gokwe North,,1702,5665,2948,2717,1110
170213,13,Midlands,Gokwe North,,1702,6309,3287,3022,1346
170224,24,Midlands,Gokwe North,,1702,2185,1076,1109,421
170234,34,Midlands,Gokwe North,,1702,6186,3223,2963,1201
170209,9,Midlands,Gokwe North,,1702,10049,5112,4937,2074
170311,11,Midlands,Gokwe South,,1703,12515,6565,5950,2653
170212,12,Midlands,Gokwe North,,1702,7142,3717,3425,1592
170211,11,Midlands,Gokwe North,,1702,8233,4242,3991,1826
170210,10,Midlands,Gokwe North,,1702,5006,2657,2349,1040
170317,17,Midlands,Gokwe South,,1703,6324,3210,3114,1267
140515,15,Mashonaland West,Makonde,,1405,4766,2371,2395,1069
142815,15,Mashonaland West,Sanyati,,1428,892,469,423,184
142817,17,Mashonaland West,Sanyati,,1428,5077,2539,2538,1042
170225,25,Midlands,Gokwe North,,1702,3266,1633,1633,643
170208,8,Midlands,Gokwe North,,1702,7883,4087,3796,1562
142814,14,Mashonaland West,Sanyati,,1428,1285,606,679,270
142813,13,Mashonaland West,Sanyati,,1428,881,442,439,169
140627,27,Mashonaland West,Zvimba,,1406,2730,1358,1372,605
142501,1,Mashonaland West,Norton,,1425,4426,2345,2081,1037
142503,3,Mashonaland West,Norton,,1425,3157,1666,1491,742
142511,11,Mashonaland West,Norton,,1425,5405,2806,2599,1356
142502,2,Mashonaland West,Norton,,1425,535,242,293,139
140117,17,Mashonaland West,Chegutu,,1401,1162,579,583,670
140122,22,Mashonaland West,Chegutu,,1401,9465,4560,4905,2181
140111,11,Mashonaland West,Chegutu,,1401,8184,3997,4187,1847
140301,1,Mashonaland West,Kadoma Urban,,1403,6827,3549,3278,1721
140621,21,Mashonaland West,Zvimba,,1406,12132,5716,6416,2940
140606,6,Mashonaland West,Zvimba,,1406,5726,2956,2770,1383
140604,4,Mashonaland West,Zvimba,,1406,2840,1516,1324,654
140124,24,Mashonaland West,Chegutu,,1401,7404,3449,3955,1830
140123,23,Mashonaland West,Chegutu,,1401,4971,2369,2602,1150
140109,9,Mashonaland West,Chegutu,,1401,5765,2998,2767,1388
140110,10,Mashonaland West,Chegutu,,1401,9839,5195,4644,2415
140127,27,Mashonaland West,Chegutu,,1401,3317,1721,1596,751
140104,4,Mashonaland West,Chegutu,,1401,7773,4077,3696,2041
140112,12,Mashonaland West,Chegutu,,1401,5350,2551,2799,1356
140129,29,Mashonaland West,Chegutu,,1401,3764,1763,2001,1069
140103,3,Mashonaland West,Chegutu,,1401,6162,3256,2906,1467
130811,11,Mashonaland East,Seke,,1308,1091,518,573,267
140108,8,Mashonaland West,Chegutu,,1401,8285,4288,3997,2042
140107,7,Mashonaland West,Chegutu,,1401,3439,1830,1609,816
140105,5,Mashonaland West,Chegutu,,1401,3327,1655,1672,896
142714,14,Mashonaland West,Mhondoro-Ngezi,,1427,12224,5746,6478,2709
142713,13,Mashonaland West,Mhondoro-Ngezi,,1427,16946,7252,9694,3664
140601,1,Mashonaland West,Zvimba,,1406,4498,2364,2134,1070
140608,8,Mashonaland West,Zvimba,,1406,3856,2048,1808,878
140125,25,Mashonaland West,Chegutu,,1401,5510,2556,2954,1193
140609,9,Mashonaland West,Zvimba,,1406,3406,1787,1619,735
140628,28,Mashonaland West,Zvimba,,1406,1654,856,798,418
142312,12,Mashonaland West,Chegutu Urban,,1423,11760,6214,5546,3058
140629,29,Mashonaland West,Zvimba,,1406,3270,1714,1556,761
140120,20,Mashonaland West,Chegutu,,1401,6161,2972,3189,1290
140128,28,Mashonaland West,Chegutu,,1401,3510,1711,1799,899
142301,1,Mashonaland West,Chegutu Urban,,1423,1289,704,585,312
142310,10,Mashonaland West,Chegutu Urban,,1423,3946,2134,1812,960
142304,4,Mashonaland West,Chegutu Urban,,1423,3591,1844,1747,900
140119,19,Mashonaland West,Chegutu,,1401,1228,570,658,278
140602,2,Mashonaland West,Zvimba,,1406,2333,1239,1094,639
140607,7,Mashonaland West,Zvimba,,1406,5299,2722,2577,1148
140603,3,Mashonaland West,Zvimba,,1406,5428,2838,2590,1311
140605,5,Mashonaland West,Zvimba,,1406,3490,1854,1636,830
142307,7,Mashonaland West,Chegutu Urban,,1423,3738,1963,1775,946
142309,9,Mashonaland West,Chegutu Urban,,1423,3061,1594,1467,758
142306,6,Mashonaland West,Chegutu Urban,,1423,3679,1947,1732,928
140626,26,Mashonaland West,Zvimba,,1406,17965,8968,8997,4453
140114,14,Mashonaland West,Chegutu,,1401,4812,2305,2507,1246
142305,5,Mashonaland West,Chegutu Urban,,1423,1629,801,828,433
142308,8,Mashonaland West,Chegutu Urban,,1423,3345,1750,1595,848
142311,11,Mashonaland West,Chegutu Urban,,1423,6981,3675,3306,1830
140113,13,Mashonaland West,Chegutu,,1401,3890,1837,2053,960
142302,2,Mashonaland West,Chegutu Urban,,1423,1912,1033,879,460
142303,3,Mashonaland West,Chegutu Urban,,1423,4901,2610,2291,1201
140314,14,Mashonaland West,Kadoma Urban,,1403,5284,2604,2680,1785
140309,9,Mashonaland West,Kadoma Urban,,1403,1804,899,905,499
140307,7,Mashonaland West,Kadoma Urban,,1403,3718,1951,1767,917
140116,16,Mashonaland West,Chegutu,,1401,1754,890,864,342
140303,3,Mashonaland West,Kadoma Urban,,1403,5382,2823,2559,1334
140312,12,Mashonaland West,Kadoma Urban,,1403,3326,1762,1564,804
140118,18,Mashonaland West,Chegutu,,1401,1010,489,521,221
140310,10,Mashonaland West,Kadoma Urban,,1403,6313,3335,2978,1550
140313,13,Mashonaland West,Kadoma Urban,,1403,5378,2819,2559,1295
140308,8,Mashonaland West,Kadoma Urban,,1403,8742,4632,4110,2266
140305,5,Mashonaland West,Kadoma Urban,,1403,3638,1937,1701,959
140302,2,Mashonaland West,Kadoma Urban,,1403,8366,4324,4042,2203
140306,6,Mashonaland West,Kadoma Urban,,1403,7015,3720,3295,1659
140304,4,Mashonaland West,Kadoma Urban,,1403,3620,1931,1689,927
142506,6,Mashonaland West,Norton,,1425,2364,1244,1120,583
142504,4,Mashonaland West,Norton,,1425,7756,3969,3787,1882
130609,9,Mashonaland East,Murehwa,,1306,4288,2153,2135,992
130611,11,Mashonaland East,Murehwa,,1306,10848,5714,5134,2463
130207,7,Mashonaland East,Goromonzi,,1302,5914,2918,2996,1455
130616,16,Mashonaland East,Murehwa,,1306,7431,3929,3502,1784
130209,9,Mashonaland East,Goromonzi,,1302,4569,2216,2353,1265
130212,12,Mashonaland East,Goromonzi,,1302,14517,7510,7007,3634
130218,18,Mashonaland East,Goromonzi,,1302,7874,4031,3843,1938
130217,17,Mashonaland East,Goromonzi,,1302,4955,2398,2557,1410
130614,14,Mashonaland East,Murehwa,,1306,7513,3946,3567,1789
130615,15,Mashonaland East,Murehwa,,1306,6330,3386,2944,1557
130628,28,Mashonaland East,Murehwa,,1306,5399,2905,2494,1330
130208,8,Mashonaland East,Goromonzi,,1302,5741,2861,2880,1563
130213,13,Mashonaland East,Goromonzi,,1302,2858,1328,1530,765
130613,13,Mashonaland East,Murehwa,,1306,5987,3208,2779,1442
130216,16,Mashonaland East,Goromonzi,,1302,15923,8219,7704,3751
130214,14,Mashonaland East,Goromonzi,,1302,9693,4744,4949,2462
130627,27,Mashonaland East,Murehwa,,1306,9233,4843,4390,2250
130225,25,Mashonaland East,Goromonzi,,1302,26888,13537,13351,7234
130625,25,Mashonaland East,Murehwa,,1306,6068,3161,2907,1521
130626,26,Mashonaland East,Murehwa,,1306,7401,3886,3515,1767
130219,19,Mashonaland East,Goromonzi,,1302,258,138,120,67
130403,3,Mashonaland East,Marondera,,1304,7280,3389,3891,2035
130401,1,Mashonaland East,Marondera,,1304,5261,2545,2716,1426
130220,20,Mashonaland East,Goromonzi,,1302,5550,2679,2871,1470
130629,29,Mashonaland East,Murehwa,,1306,4534,2439,2095,1260
130414,14,Mashonaland East,Marondera,,1304,6689,3427,3262,1664
130816,16,Mashonaland East,Seke,,1308,1412,705,707,302
130415,15,Mashonaland East,Marondera,,1304,5410,2701,2709,1383
130416,16,Mashonaland East,Marondera,,1304,3857,2016,1841,981
130417,17,Mashonaland East,Marondera,,1304,3315,1706,1609,850
130422,22,Mashonaland East,Marondera,,1304,4275,2102,2173,926
130421,21,Mashonaland East,Marondera,,1304,5341,2697,2644,1304
132109,9,Mashonaland East,Marondera Urban,,1321,6115,3317,2798,1653
132112,12,Mashonaland East,Marondera Urban,,1321,6253,3486,2767,1657
130423,23,Mashonaland East,Marondera,,1304,9418,4615,4803,2451
132111,11,Mashonaland East,Marondera Urban,,1321,1264,646,618,390
132609,9,Mashonaland East,Ruwa,,1326,14930,7646,7284,3676
130402,2,Mashonaland East,Marondera,,1304,3392,1538,1854,959
132605,5,Mashonaland East,Ruwa,,1326,2329,1254,1075,569
132603,3,Mashonaland East,Ruwa,,1326,3731,2024,1707,890
132604,4,Mashonaland East,Ruwa,,1326,2368,1258,1110,580
130404,4,Mashonaland East,Marondera,,1304,5546,2656,2890,1402
132606,6,Mashonaland East,Ruwa,,1326,2896,1576,1320,723
132104,4,Mashonaland East,Marondera Urban,,1321,8432,4451,3981,2212
132105,5,Mashonaland East,Marondera Urban,,1321,3956,2031,1925,1052
130805,5,Mashonaland East,Seke,,1308,2562,1331,1231,705
130806,6,Mashonaland East,Seke,,1308,3880,2001,1879,939
130418,18,Mashonaland East,Marondera,,1304,3763,1961,1802,957
132107,7,Mashonaland East,Marondera Urban,,1321,4452,2341,2111,1233
130413,13,Mashonaland East,Marondera,,1304,3546,1830,1716,882
132103,3,Mashonaland East,Marondera Urban,,1321,5843,3121,2722,1480
132110,10,Mashonaland East,Marondera Urban,,1321,6660,3582,3078,1749
130406,6,Mashonaland East,Marondera,,1304,7922,3870,4052,2005
130411,11,Mashonaland East,Marondera,,1304,6306,3331,2975,1620
130409,9,Mashonaland East,Marondera,,1304,673,310,363,160
130412,12,Mashonaland East,Marondera,,1304,5471,2905,2566,1381
130815,15,Mashonaland East,Seke,,1308,3475,1683,1792,867
130819,19,Mashonaland East,Seke,,1308,1674,804,870,368
130410,10,Mashonaland East,Marondera,,1304,4774,2508,2266,1213
130405,5,Mashonaland East,Marondera,,1304,7142,3359,3783,2051
132106,6,Mashonaland East,Marondera Urban,,1321,3824,1969,1855,1059
130419,19,Mashonaland East,Marondera,,1304,3081,1607,1474,783
132108,8,Mashonaland East,Marondera Urban,,1321,7465,4049,3416,2036
130420,20,Mashonaland East,Marondera,,1304,4208,2195,2013,1005
130818,18,Mashonaland East,Seke,,1308,1752,862,890,409
140635,35,Mashonaland West,Zvimba,,1406,24079,12227,11852,6005
192101,1,Harare,Harare,Harare Rural,1921,113120,56794,56326,28691
192206,6,Harare,Chitungwiza,,1922,17156,9113,8043,4087
130810,10,Mashonaland East,Seke,,1308,8838,4271,4567,2303
192212,12,Harare,Chitungwiza,,1922,15111,7908,7203,3690
192218,18,Harare,Chitungwiza,,1922,17496,9162,8334,4328
130808,8,Mashonaland East,Seke,,1308,10696,5584,5112,2431
192224,24,Harare,Chitungwiza,,1922,20700,10738,9962,5161
192223,23,Harare,Chitungwiza,,1922,28068,14665,13403,6910
192222,22,Harare,Chitungwiza,,1922,15254,8072,7182,3787
192121,21,Harare,Harare,,1921,22973,11722,11251,5662
192120,20,Harare,Harare,,1921,24256,12459,11797,5950
132608,8,Mashonaland East,Ruwa,,1326,13695,7340,6355,3312
192146,46,Harare,Harare,,1921,10470,5452,5018,2548
130215,15,Mashonaland East,Goromonzi,,1302,6617,3328,3289,1498
192122,22,Harare,Harare,,1921,37313,19934,17379,8624
192307,7,Harare,Epworth,,1923,39031,19558,19473,10662
192109,9,Harare,Harare,,1921,46312,23837,22475,12379
192118,18,Harare,Harare,,1921,32632,16291,16341,9980
192225,25,Harare,Chitungwiza,,1922,12638,6684,5954,3081
192221,21,Harare,Chitungwiza,,1922,18633,10170,8463,4369
192133,33,Harare,Harare,,1921,59969,31114,28855,15232
192144,44,Harare,Harare,,1921,27225,14710,12515,6286
192128,28,Harare,Harare,,1921,27364,14385,12979,6502
192204,4,Harare,Chitungwiza,,1922,27468,14263,13205,6912
192136,36,Harare,Harare,,1921,12487,6512,5975,2848
192135,35,Harare,Harare,,1921,23868,12323,11545,5695
120118,18,Mashonaland Central,Bindura,,1201,3714,1960,1754,894
120420,20,Mashonaland Central,Mazowe,,1204,12040,5780,6260,3096
192142,42,Harare,Harare,,1921,45355,22885,22470,11658
192141,41,Harare,Harare,,1921,55398,29546,25852,13706
140624,24,Mashonaland West,Zvimba,,1406,8961,4424,4537,2220
192117,17,Harare,Harare,,1921,24632,12622,12010,7599
130809,9,Mashonaland East,Seke,,1308,8964,4225,4739,2326
192130,30,Harare,Harare,,1921,53268,27553,25715,13551
192132,32,Harare,Harare,,1921,37655,19531,18124,9534
192108,8,Harare,Harare,,1921,20298,10182,10116,6698
192107,7,Harare,Harare,,1921,29258,13903,15355,7925
192134,34,Harare,Harare,,1921,18167,9390,8777,4366
192126,26,Harare,Harare,,1921,36763,18485,18278,9689
192143,43,Harare,Harare,,1921,60229,31360,28869,14831
192116,16,Harare,Harare,,1921,45756,24815,20941,10978
192140,40,Harare,Harare,,1921,45180,23189,21991,10922
192139,39,Harare,Harare,,1921,24050,12288,11762,5871
192145,45,Harare,Harare,,1921,28926,15136,13790,7135
192137,37,Harare,Harare,,1921,70508,36484,34024,17616
192305,5,Harare,Epworth,,1923,11558,5754,5804,3212
192303,3,Harare,Epworth,,1923,15931,7900,8031,4322
192115,15,Harare,Harare,,1921,66054,34840,31214,15787
192138,38,Harare,Harare,,1921,34371,17760,16611,8658
192124,24,Harare,Harare,,1921,29464,15162,14302,7846
192125,25,Harare,Harare,,1921,30202,15648,14554,7955
192131,31,Harare,Harare,,1921,22955,11936,11019,5738
192127,27,Harare,Harare,,1921,32187,16738,15449,8048
192129,29,Harare,Harare,,1921,13251,7011,6240,3268
192103,3,Harare,Harare,,1921,22243,10750,11493,5727
192112,12,Harare,Harare,,1921,22284,11373,10911,5380
192123,23,Harare,Harare,,1921,63360,33555,29805,14485
110718,18,Manicaland,Nyanga,,1107,4093,2248,1845,1149
110717,17,Manicaland,Nyanga,,1107,4032,2171,1861,1076
192102,2,Harare,Harare,,1921,36292,19948,16344,9300
192105,5,Harare,Harare,,1921,21714,11352,10362,5782
192114,14,Harare,Harare,,1921,30521,15744,14777,7890
192106,6,Harare,Harare,,1921,21520,11929,9591,6761
192110,10,Harare,Harare,,1921,21971,11411,10560,5571
192104,4,Harare,Harare,,1921,14970,7180,7790,3926
192119,19,Harare,Harare,,1921,21145,10790,10355,5164
192306,6,Harare,Epworth,,1923,25597,12838,12759,7167
192301,1,Harare,Epworth,,1923,31475,15570,15905,8879
192205,5,Harare,Chitungwiza,,1922,10730,5565,5165,2791
192203,3,Harare,Chitungwiza,,1922,10009,5095,4914,2565
192202,2,Harare,Chitungwiza,,1922,11024,5678,5346,2924
192201,1,Harare,Chitungwiza,,1922,8286,4391,3895,2075
192208,8,Harare,Chitungwiza,,1922,10023,5312,4711,2263
192210,10,Harare,Chitungwiza,,1922,8793,4608,4185,2080
192211,11,Harare,Chitungwiza,,1922,9379,5140,4239,2227
192213,13,Harare,Chitungwiza,,1922,9832,5324,4508,2398
192214,14,Harare,Chitungwiza,,1922,15467,8191,7276,3708
192215,15,Harare,Chitungwiza,,1922,13485,7011,6474,3378
192216,16,Harare,Chitungwiza,,1922,14688,7985,6703,3961
192219,19,Harare,Chitungwiza,,1922,16658,8849,7809,4042
192220,20,Harare,Chitungwiza,,1922,11284,5812,5472,2864
192217,17,Harare,Chitungwiza,,1922,16163,8700,7463,3733
110730,30,Manicaland,Nyanga,,1107,3062,1633,1429,748
130620,20,Mashonaland East,Murehwa,,1306,4998,2631,2367,1256
130729,29,Mashonaland East,Mutoko,,1307,10066,5050,5016,2191
110435,35,Manicaland,Makoni,,1104,9891,4913,4978,2164
110706,6,Manicaland,Nyanga,,1107,3913,2125,1788,966
110710,10,Manicaland,Nyanga,,1107,3334,1839,1495,868
110707,7,Manicaland,Nyanga,,1107,4383,2383,2000,1068
110709,9,Manicaland,Nyanga,,1107,5412,2869,2543,1352
110436,36,Manicaland,Makoni,,1104,5447,2841,2606,1369
110711,11,Manicaland,Nyanga,,1107,3299,1788,1511,912
110712,12,Manicaland,Nyanga,,1107,4438,2335,2103,1071
110708,8,Manicaland,Nyanga,,1107,3319,1761,1558,850
110720,20,Manicaland,Nyanga,,1107,3142,1141,2001,1365
110716,16,Manicaland,Nyanga,,1107,2621,1310,1311,581
110406,6,Manicaland,Makoni,,1104,9884,4757,5127,2257
110722,22,Manicaland,Nyanga,,1107,2942,1594,1348,778
110727,27,Manicaland,Nyanga,,1107,2241,1144,1097,552
110728,28,Manicaland,Nyanga,,1107,619,268,351,196
110604,4,Manicaland,Mutasa,,1106,5934,3171,2763,1444
110606,6,Manicaland,Mutasa,,1106,6570,3634,2936,1544
110605,5,Manicaland,Mutasa,,1106,7677,4235,3442,1812
110630,30,Manicaland,Mutasa,,1106,5140,2757,2383,1245
110731,31,Manicaland,Nyanga,,1107,2093,1073,1020,539
110410,10,Manicaland,Makoni,,1104,6247,3151,3096,1357
110628,28,Manicaland,Mutasa,,1106,3718,2053,1665,934
110721,21,Manicaland,Nyanga,,1107,6010,3256,2754,1474
110631,31,Manicaland,Mutasa,,1106,3522,1916,1606,933
110725,25,Manicaland,Nyanga,,1107,2507,1192,1315,925
110607,7,Manicaland,Mutasa,,1106,8587,4624,3963,2088
110729,29,Manicaland,Nyanga,,1107,4445,2348,2097,1359
110724,24,Manicaland,Nyanga,,1107,1973,939,1034,585
140407,7,Mashonaland West,Kariba,,1404,1633,832,801,385
140406,6,Mashonaland West,Kariba,,1404,2242,1125,1117,478
170229,29,Midlands,Gokwe North,,1702,3678,1937,1741,811
140404,4,Mashonaland West,Kariba,,1404,5866,3042,2824,1408
170218,18,Midlands,Gokwe North,,1702,5339,2761,2578,1134
110602,2,Manicaland,Mutasa,,1106,2571,1232,1339,856
110601,1,Manicaland,Mutasa,,1106,9369,5126,4243,2170
110603,3,Manicaland,Mutasa,,1106,9374,5117,4257,2205
110629,29,Manicaland,Mutasa,,1106,2045,1105,940,518
140226,26,Mashonaland West,Hurungwe,,1402,6554,3328,3226,1401
140634,34,Mashonaland West,Zvimba,,1406,5671,2830,2841,1279
140632,32,Mashonaland West,Zvimba,,1406,7571,3735,3836,1783
142607,7,Mashonaland West,Karoi,,1426,1927,965,962,447
142605,5,Mashonaland West,Karoi,,1426,1971,1079,892,515
142603,3,Mashonaland West,Karoi,,1426,1794,1002,792,511
142602,2,Mashonaland West,Karoi,,1426,1160,632,528,281
142606,6,Mashonaland West,Karoi,,1426,1586,878,708,491
142604,4,Mashonaland West,Karoi,,1426,1787,965,822,486
142601,1,Mashonaland West,Karoi,,1426,2357,1296,1061,615
140223,23,Mashonaland West,Hurungwe,,1402,8154,4055,4099,1790
140216,16,Mashonaland West,Hurungwe,,1402,16489,8382,8107,3654
170220,20,Midlands,Gokwe North,,1702,5089,2575,2514,942
170223,23,Midlands,Gokwe North,,1702,6706,3523,3183,1363
170221,21,Midlands,Gokwe North,,1702,4196,2132,2064,855
140224,24,Mashonaland West,Hurungwe,,1402,11499,5877,5622,2473
140225,25,Mashonaland West,Hurungwe,,1402,14615,7500,7115,3141
140409,9,Mashonaland West,Kariba,,1404,2999,1455,1544,640
140402,2,Mashonaland West,Kariba,,1404,2112,986,1126,516
140505,5,Mashonaland West,Makonde,,1405,10425,5104,5321,2144
140507,7,Mashonaland West,Makonde,,1405,2949,1545,1404,728
140614,14,Mashonaland West,Zvimba,,1406,7217,3516,3701,1707
140613,13,Mashonaland West,Zvimba,,1406,12447,6120,6327,2759
140616,16,Mashonaland West,Zvimba,,1406,1769,901,868,439
120315,15,Mashonaland Central,Guruve,,1203,2298,1099,1199,465
140617,17,Mashonaland West,Zvimba,,1406,10886,5292,5594,2331
140623,23,Mashonaland West,Zvimba,,1406,3115,1608,1507,704
140622,22,Mashonaland West,Zvimba,,1406,7188,3805,3383,1878
140509,9,Mashonaland West,Makonde,,1405,9102,4505,4597,1865
142115,15,Mashonaland West,Chinhoyi,,1421,3664,1874,1790,834
140630,30,Mashonaland West,Zvimba,,1406,10131,5013,5118,2341
140618,18,Mashonaland West,Zvimba,,1406,7005,3417,3588,1636
120307,7,Mashonaland Central,Guruve,,1203,7970,4411,3559,1583
120322,22,Mashonaland Central,Guruve,,1203,7532,4068,3464,1633
142111,11,Mashonaland West,Chinhoyi,,1421,5304,2594,2710,725
142103,3,Mashonaland West,Chinhoyi,,1421,8330,4585,3745,1973
142113,13,Mashonaland West,Chinhoyi,,1421,4010,2124,1886,924
142105,5,Mashonaland West,Chinhoyi,,1421,10365,5496,4869,2537
142114,14,Mashonaland West,Chinhoyi,,1421,5043,2628,2415,1183
142109,9,Mashonaland West,Chinhoyi,,1421,2574,1306,1268,583
140506,6,Mashonaland West,Makonde,,1405,5824,2786,3038,1318
142110,10,Mashonaland West,Chinhoyi,,1421,2803,1310,1493,664
142108,8,Mashonaland West,Chinhoyi,,1421,7688,4180,3508,2097
140631,31,Mashonaland West,Zvimba,,1406,6796,3309,3487,1523
142112,12,Mashonaland West,Chinhoyi,,1421,7030,3717,3313,1677
142104,4,Mashonaland West,Chinhoyi,,1421,8162,4312,3850,1941
142107,7,Mashonaland West,Chinhoyi,,1421,4897,2588,2309,1224
142106,6,Mashonaland West,Chinhoyi,,1421,3762,2007,1755,967
140513,13,Mashonaland West,Makonde,,1405,6456,3132,3324,1388
140504,4,Mashonaland West,Makonde,,1405,11998,5929,6069,2586
140511,11,Mashonaland West,Makonde,,1405,15599,7873,7726,3594
130910,10,Mashonaland East,Uzumba Maramba Pfungwe,,1309,6684,3491,3193,1518
130913,13,Mashonaland East,Uzumba Maramba Pfungwe,,1309,8851,4639,4212,2080
130912,12,Mashonaland East,Uzumba Maramba Pfungwe,,1309,6130,3195,2935,1518
130914,14,Mashonaland East,Uzumba Maramba Pfungwe,,1309,7446,3900,3546,1811
120721,21,Mashonaland Central,Shamva,,1207,3400,1511,1889,721
130915,15,Mashonaland East,Uzumba Maramba Pfungwe,,1309,7068,3705,3363,1705
130601,1,Mashonaland East,Murehwa,,1306,4193,2144,2049,1017
122110,10,Mashonaland Central,Bindura Urban,,1221,3689,1952,1737,926
122109,9,Mashonaland Central,Bindura Urban,,1221,4609,2404,2205,1183
130602,2,Mashonaland East,Murehwa,,1306,4141,2106,2035,990
130908,8,Mashonaland East,Uzumba Maramba Pfungwe,,1309,7054,3598,3456,1654
130907,7,Mashonaland East,Uzumba Maramba Pfungwe,,1309,2972,1476,1496,638
130909,9,Mashonaland East,Uzumba Maramba Pfungwe,,1309,7436,3854,3582,1713
130906,6,Mashonaland East,Uzumba Maramba Pfungwe,,1309,6840,3539,3301,1679
120513,13,Mashonaland Central,Mount Darwin,,1205,1473,724,749,312
120514,14,Mashonaland Central,Mount Darwin,,1205,7623,4028,3595,1712
120520,20,Mashonaland Central,Mount Darwin,,1205,5241,2659,2582,1076
120406,6,Mashonaland Central,Mazowe,,1204,5731,3071,2660,1329
120407,7,Mashonaland Central,Mazowe,,1204,5506,2888,2618,1315
120529,29,Mashonaland Central,Mount Darwin,,1205,1332,676,656,272
120527,27,Mashonaland Central,Mount Darwin,,1205,4710,2230,2480,935
120524,24,Mashonaland Central,Mount Darwin,,1205,8672,4449,4223,1958
120526,26,Mashonaland Central,Mount Darwin,,1205,8088,4290,3798,2125
120525,25,Mashonaland Central,Mount Darwin,,1205,1436,729,707,327
120528,28,Mashonaland Central,Mount Darwin,,1205,1073,536,537,221
120521,21,Mashonaland Central,Mount Darwin,,1205,797,387,410,174
120523,23,Mashonaland Central,Mount Darwin,,1205,7881,4214,3667,1393
120516,16,Mashonaland Central,Mount Darwin,,1205,4125,2166,1959,866
120213,13,Mashonaland Central,Centenary,,1202,2813,1339,1474,639
120214,14,Mashonaland Central,Centenary,,1202,6972,3367,3605,1560
120539,39,Mashonaland Central,Mount Darwin,,1205,4095,2057,2038,801
120228,28,Mashonaland Central,Centenary,,1202,5353,2596,2757,1219
120401,1,Mashonaland Central,Mazowe,,1204,5713,3058,2655,1292
120403,3,Mashonaland Central,Mazowe,,1204,4858,2529,2329,1178
120402,2,Mashonaland Central,Mazowe,,1204,4575,2383,2192,1077
120222,22,Mashonaland Central,Centenary,,1202,1885,942,943,415
122108,8,Mashonaland Central,Bindura Urban,,1221,4825,2586,2239,1229
120416,16,Mashonaland Central,Mazowe,,1204,8063,4016,4047,1967
120703,3,Mashonaland Central,Shamva,,1207,5172,2746,2426,1209
120702,2,Mashonaland Central,Shamva,,1207,1972,1044,928,492
120704,4,Mashonaland Central,Shamva,,1207,2307,1249,1058,537
120540,40,Mashonaland Central,Mount Darwin,,1205,6528,3091,3437,1440
120404,4,Mashonaland Central,Mazowe,,1204,4328,2239,2089,1053
120405,5,Mashonaland Central,Mazowe,,1204,5385,2848,2537,1288
120705,5,Mashonaland Central,Shamva,,1207,4070,2180,1890,918
120701,1,Mashonaland Central,Shamva,,1207,4092,2120,1972,952
120725,25,Mashonaland Central,Shamva,,1207,1896,974,922,436
120102,2,Mashonaland Central,Bindura,,1201,7110,3465,3645,1473
120427,27,Mashonaland Central,Mazowe,,1204,11932,5852,6080,2756
120726,26,Mashonaland Central,Shamva,,1207,1975,1038,937,484
120710,10,Mashonaland Central,Shamva,,1207,3893,2087,1806,888
120708,8,Mashonaland Central,Shamva,,1207,4552,2425,2127,1068
120105,5,Mashonaland Central,Bindura,,1201,5786,2897,2889,1350
120714,14,Mashonaland Central,Shamva,,1207,3853,1944,1909,800
120428,28,Mashonaland Central,Mazowe,,1204,3565,1734,1831,880
120723,23,Mashonaland Central,Shamva,,1207,3004,1260,1744,628
120728,28,Mashonaland Central,Shamva,,1207,3565,1734,1831,880
120101,1,Mashonaland Central,Bindura,,1201,4709,2281,2428,1011
120408,8,Mashonaland Central,Mazowe,,1204,9902,5189,4713,2410
120709,9,Mashonaland Central,Shamva,,1207,5844,3055,2789,1405
130904,4,Mashonaland East,Uzumba Maramba Pfungwe,,1309,10216,5220,4996,2238
130504,4,Mashonaland East,Mudzi,,1305,8667,4574,4093,2055
130903,3,Mashonaland East,Uzumba Maramba Pfungwe,,1309,5299,2771,2528,1212
130505,5,Mashonaland East,Mudzi,,1305,5980,3132,2848,1357
130506,6,Mashonaland East,Mudzi,,1305,5940,3175,2765,1456
130512,12,Mashonaland East,Mudzi,,1305,9791,5169,4622,2251
120715,15,Mashonaland Central,Shamva,,1207,4720,2361,2359,985
120104,4,Mashonaland Central,Bindura,,1201,5703,2785,2918,1245
120103,3,Mashonaland Central,Bindura,,1201,8709,4285,4424,1853
120410,10,Mashonaland Central,Mazowe,,1204,6512,3379,3133,1551
120409,9,Mashonaland Central,Mazowe,,1204,6476,3476,3000,1552
120425,25,Mashonaland Central,Mazowe,,1204,7027,3445,3582,1610
120413,13,Mashonaland Central,Mazowe,,1204,5552,2945,2607,1312
120412,12,Mashonaland Central,Mazowe,,1204,8103,4380,3723,1879
120411,11,Mashonaland Central,Mazowe,,1204,6711,3569,3142,1524
120711,11,Mashonaland Central,Shamva,,1207,4429,2325,2104,1038
130508,8,Mashonaland East,Mudzi,,1305,6593,3552,3041,1601
130507,7,Mashonaland East,Mudzi,,1305,9530,5024,4506,2368
130516,16,Mashonaland East,Mudzi,,1305,6702,3507,3195,1620
130703,3,Mashonaland East,Mutoko,,1307,4586,2482,2104,1085
130704,4,Mashonaland East,Mutoko,,1307,5093,2621,2472,1268
130707,7,Mashonaland East,Mutoko,,1307,4710,2425,2285,1233
130702,2,Mashonaland East,Mutoko,,1307,7267,3684,3583,1716
130515,15,Mashonaland East,Mudzi,,1305,9854,5105,4749,2199
130518,18,Mashonaland East,Mudzi,,1305,4758,2449,2309,1156
130513,13,Mashonaland East,Mudzi,,1305,3893,2044,1849,1049
130709,9,Mashonaland East,Mutoko,,1307,3354,1732,1622,796
130706,6,Mashonaland East,Mutoko,,1307,2181,1146,1035,571
120713,13,Mashonaland Central,Shamva,,1207,3022,1466,1556,712
130911,11,Mashonaland East,Uzumba Maramba Pfungwe,,1309,7828,4037,3791,1835
120120,20,Mashonaland Central,Bindura,,1201,7550,3702,3848,1840
120712,12,Mashonaland Central,Shamva,,1207,3718,1900,1818,871
120727,27,Mashonaland Central,Shamva,,1207,3640,1792,1848,731
120414,14,Mashonaland Central,Mazowe,,1204,8448,4165,4283,1980
120418,18,Mashonaland Central,Mazowe,,1204,5187,2395,2792,1233
120432,32,Mashonaland Central,Mazowe,,1204,5091,2462,2629,1266
130727,27,Mashonaland East,Mutoko,,1307,8194,4083,4111,1809
130720,20,Mashonaland East,Mutoko,,1307,12398,6604,5794,3493
130721,21,Mashonaland East,Mutoko,,1307,766,346,420,174
120121,21,Mashonaland Central,Bindura,,1201,10040,4885,5155,2290
120119,19,Mashonaland Central,Bindura,,1201,7253,3583,3670,1672
120415,15,Mashonaland Central,Mazowe,,1204,4864,2563,2301,1231
120107,7,Mashonaland Central,Bindura,,1201,5687,2755,2932,1284
120110,10,Mashonaland Central,Bindura,,1201,7196,3708,3488,1646
122101,1,Mashonaland Central,Bindura Urban,,1221,4464,2338,2126,1214
120729,29,Mashonaland Central,Shamva,,1207,7230,3414,3816,1698
120722,22,Mashonaland Central,Shamva,,1207,6225,3250,2975,1659
122102,2,Mashonaland Central,Bindura Urban,,1221,2858,1369,1489,683
120106,6,Mashonaland Central,Bindura,,1201,6821,3248,3573,1670
120113,13,Mashonaland Central,Bindura,,1201,3254,1638,1616,760
130728,28,Mashonaland East,Mutoko,,1307,5391,2784,2607,1256
130722,22,Mashonaland East,Mutoko,,1307,1481,751,730,307
110702,2,Manicaland,Nyanga,,1107,5312,2869,2443,1256
120109,9,Mashonaland Central,Bindura,,1201,4718,2401,2317,1065
120625,25,Mashonaland Central,Rushinga,,1206,1196,614,582,250
110701,1,Manicaland,Nyanga,,1107,4924,2565,2359,1115
120718,18,Mashonaland Central,Shamva,,1207,3320,1613,1707,740
120720,20,Mashonaland Central,Shamva,,1207,6459,3075,3384,1514
120108,8,Mashonaland Central,Bindura,,1201,4580,2215,2365,1026
142402,2,Mashonaland West,Kariba Urban,,1424,7209,3623,3586,1847
120114,14,Mashonaland Central,Bindura,,1201,4161,2201,1960,961
120522,22,Mashonaland Central,Mount Darwin,,1205,8680,4338,4342,1771
142401,1,Mashonaland West,Kariba Urban,,1424,5242,2653,2589,1351
120422,22,Mashonaland Central,Mazowe,,1204,4671,2246,2425,1221
120435,35,Mashonaland Central,Mazowe,,1204,3880,1936,1944,925
120421,21,Mashonaland Central,Mazowe,,1204,6777,3218,3559,1694
122103,3,Mashonaland Central,Bindura Urban,,1221,1212,546,666,315
122112,12,Mashonaland Central,Bindura Urban,,1221,8447,4378,4069,2137
142403,3,Mashonaland West,Kariba Urban,,1424,5715,2962,2753,1480
120226,26,Mashonaland Central,Centenary,,1202,4087,1972,2115,946
122111,11,Mashonaland Central,Bindura Urban,,1221,2613,1374,1239,597
122106,6,Mashonaland Central,Bindura Urban,,1221,3111,1588,1523,769
120717,17,Mashonaland Central,Shamva,,1207,6829,3269,3560,1478
120215,15,Mashonaland Central,Centenary,,1202,3350,1761,1589,864
120706,6,Mashonaland Central,Shamva,,1207,3645,1965,1680,873
120707,7,Mashonaland Central,Shamva,,1207,3685,1921,1764,870
122104,4,Mashonaland Central,Bindura Urban,,1221,3424,1761,1663,903
122105,5,Mashonaland Central,Bindura Urban,,1221,2896,1490,1406,749
122107,7,Mashonaland Central,Bindura Urban,,1221,1885,1005,880,467
120719,19,Mashonaland Central,Shamva,,1207,4209,2019,2190,983
130511,11,Mashonaland East,Mudzi,,1305,7611,4176,3435,1980
130517,17,Mashonaland East,Mudzi,,1305,4780,2579,2201,1199
120601,1,Mashonaland Central,Rushinga,,1206,2548,1292,1256,592
130510,10,Mashonaland East,Mudzi,,1305,9374,5105,4269,2432
130502,2,Mashonaland East,Mudzi,,1305,7954,4218,3736,2007
130902,2,Mashonaland East,Uzumba Maramba Pfungwe,,1309,5843,3062,2781,1356
130901,1,Mashonaland East,Uzumba Maramba Pfungwe,,1309,6423,3273,3150,1490
120618,18,Mashonaland Central,Rushinga,,1206,4011,2060,1951,927
130509,9,Mashonaland East,Mudzi,,1305,5186,2805,2381,1307
130503,3,Mashonaland East,Mudzi,,1305,7508,3918,3590,1877
130905,5,Mashonaland East,Uzumba Maramba Pfungwe,,1309,4578,2440,2138,1022
130701,1,Mashonaland East,Mutoko,,1307,4187,2152,2035,900
130708,8,Mashonaland East,Mutoko,,1307,2782,1428,1354,683
130713,13,Mashonaland East,Mutoko,,1307,3083,1617,1466,758
130714,14,Mashonaland East,Mutoko,,1307,4288,2201,2087,1081
130716,16,Mashonaland East,Mutoko,,1307,6711,3524,3187,1710
142406,6,Mashonaland West,Kariba Urban,,1424,1353,691,662,370
142405,5,Mashonaland West,Kariba Urban,,1424,1863,898,965,468
120802,2,Mashonaland Central,Mbire,,1208,4851,2514,2337,1149
120803,3,Mashonaland Central,Mbire,,1208,6106,3033,3073,1337
120809,9,Mashonaland Central,Mbire,,1208,4894,2437,2457,1126
120817,17,Mashonaland Central,Mbire,,1208,3812,1892,1920,834
130715,15,Mashonaland East,Mutoko,,1307,3618,1882,1736,975
130514,14,Mashonaland East,Mudzi,,1305,11706,5787,5919,2701
130705,5,Mashonaland East,Mutoko,,1307,4168,2176,1992,1059
120317,17,Mashonaland Central,Guruve,,1203,1549,776,773,323
120816,16,Mashonaland Central,Mbire,,1208,2996,1503,1493,624
120805,5,Mashonaland Central,Mbire,,1208,5289,2681,2608,1192
120813,13,Mashonaland Central,Mbire,,1208,5745,2925,2820,1258
120204,4,Mashonaland Central,Centenary,,1202,5139,2623,2516,1118
120223,23,Mashonaland Central,Centenary,,1202,9340,4487,4853,1953
120201,1,Mashonaland Central,Centenary,,1202,7505,3806,3699,1594
130712,12,Mashonaland East,Mutoko,,1307,5168,2725,2443,1342
130718,18,Mashonaland East,Mutoko,,1307,8435,4381,4054,2064
130711,11,Mashonaland East,Mutoko,,1307,4641,2413,2228,1108
130710,10,Mashonaland East,Mutoko,,1307,3667,1943,1724,955
130717,17,Mashonaland East,Mutoko,,1307,5278,2716,2562,1327
130723,23,Mashonaland East,Mutoko,,1307,950,467,483,245
120615,15,Mashonaland Central,Rushinga,,1206,3621,1957,1664,875
120502,2,Mashonaland Central,Mount Darwin,,1205,12229,6347,5882,2960
120503,3,Mashonaland Central,Mount Darwin,,1205,4531,2326,2205,1140
120205,5,Mashonaland Central,Centenary,,1202,5008,2597,2411,1125
120219,19,Mashonaland Central,Centenary,,1202,2918,1467,1451,664
120814,14,Mashonaland Central,Mbire,,1208,2409,1174,1235,553
120202,2,Mashonaland Central,Centenary,,1202,6394,3219,3175,1355
120203,3,Mashonaland Central,Centenary,,1202,2760,1404,1356,627
120612,12,Mashonaland Central,Rushinga,,1206,3976,2074,1902,881
120619,19,Mashonaland Central,Rushinga,,1206,2556,1364,1192,659
120605,5,Mashonaland Central,Rushinga,,1206,1403,694,709,320
120604,4,Mashonaland Central,Rushinga,,1206,3368,1760,1608,807
120621,21,Mashonaland Central,Rushinga,,1206,2834,1540,1294,636
120616,16,Mashonaland Central,Rushinga,,1206,3342,1776,1566,766
120614,14,Mashonaland Central,Rushinga,,1206,3505,1816,1689,814
142409,9,Mashonaland West,Kariba Urban,,1424,1630,806,824,426
120209,9,Mashonaland Central,Centenary,,1202,2481,1282,1199,562
142408,8,Mashonaland West,Kariba Urban,,1424,1197,539,658,306
120810,10,Mashonaland Central,Mbire,,1208,6917,3503,3414,1489
120227,27,Mashonaland Central,Centenary,,1202,4584,2324,2260,1024
120533,33,Mashonaland Central,Mount Darwin,,1205,6758,3499,3259,1657
120511,11,Mashonaland Central,Mount Darwin,,1205,6136,3217,2919,1394
120320,20,Mashonaland Central,Guruve,,1203,4342,2221,2121,975
120808,8,Mashonaland Central,Mbire,,1208,8397,4235,4162,1751
120807,7,Mashonaland Central,Mbire,,1208,2549,1256,1293,569
120224,24,Mashonaland Central,Centenary,,1202,5938,2974,2964,1232
120504,4,Mashonaland Central,Mount Darwin,,1205,4282,2243,2039,1030
120505,5,Mashonaland Central,Mount Darwin,,1205,4445,2239,2206,1057
120623,23,Mashonaland Central,Rushinga,,1206,2070,1071,999,462
120532,32,Mashonaland Central,Mount Darwin,,1205,1791,937,854,427
120534,34,Mashonaland Central,Mount Darwin,,1205,5512,2905,2607,1409
120531,31,Mashonaland Central,Mount Darwin,,1205,4352,2250,2102,973
120506,6,Mashonaland Central,Mount Darwin,,1205,5013,2553,2460,1147
120208,8,Mashonaland Central,Centenary,,1202,5710,2905,2805,1397
120210,10,Mashonaland Central,Centenary,,1202,8133,4261,3872,1857
120218,18,Mashonaland Central,Centenary,,1202,2345,1219,1126,493
120217,17,Mashonaland Central,Centenary,,1202,5982,3055,2927,1352
120508,8,Mashonaland Central,Mount Darwin,,1205,7943,4174,3769,1796
120507,7,Mashonaland Central,Mount Darwin,,1205,5524,2903,2621,1248
120535,35,Mashonaland Central,Mount Darwin,,1205,3939,2020,1919,875
120221,21,Mashonaland Central,Centenary,,1202,2261,1134,1127,491
120501,1,Mashonaland Central,Mount Darwin,,1205,3429,1769,1660,809
162301,1,Matabeleland South,Plumtree,,1623,2989,1671,1318,845
160207,7,Matabeleland South,Bulilima,,1602,8374,4591,3783,1824
162306,6,Matabeleland South,Plumtree,,1623,1881,970,911,539
162304,4,Matabeleland South,Plumtree,,1623,1098,590,508,269
160211,11,Matabeleland South,Bulilima,,1602,4777,2597,2180,1013
170611,11,Midlands,Mberengwa,,1706,3729,1974,1755,790
150402,2,Matabeleland North,Lupane,,1504,1850,988,862,403
150404,4,Matabeleland North,Lupane,,1504,2468,1274,1194,490
180615,15,Masvingo,Mwenezi,,1806,9211,4693,4518,2057
150509,9,Matabeleland North,Nkayi,,1505,3207,1623,1584,585
170332,32,Midlands,Gokwe South,,1703,4641,2390,2251,1030
150206,6,Matabeleland North,Bubi,,1502,157,67,90,36
130310,10,Mashonaland East,Hwedza,,1303,2589,1362,1227,662
110432,32,Manicaland,Makoni,,1104,1406,734,672,373
112210,10,Manicaland,Rusape,,1122,3394,1737,1657,855
112209,9,Manicaland,Rusape,,1122,3303,1783,1520,859
120112,12,Mashonaland Central,Bindura,,1201,3155,1644,1511,759
130203,3,Mashonaland East,Goromonzi,,1302,4921,2574,2347,1190
120806,6,Mashonaland Central,Mbire,,1208,4062,2112,1950,900
120603,3,Mashonaland Central,Rushinga,,1206,3224,1643,1581,745
120319,19,Mashonaland Central,Guruve,,1203,7313,3736,3577,1625
162302,2,Matabeleland South,Plumtree,,1623,1628,886,742,456
160304,4,Matabeleland South,Mangwe,,1603,5373,2936,2437,1113
162107,7,Matabeleland South,Gwanda Urban,,1621,3902,2181,1721,1101
162303,3,Matabeleland South,Plumtree,,1623,3448,1866,1582,994
160610,10,Matabeleland South,Matobo,,1606,3496,1921,1575,724
110713,13,Manicaland,Nyanga,,1107,2551,1399,1152,598
110714,14,Manicaland,Nyanga,,1107,3562,1969,1593,914
160507,7,Matabeleland South,Insiza,,1605,4091,2196,1895,815
162106,6,Matabeleland South,Gwanda Urban,,1621,2534,1390,1144,702
182204,4,Masvingo,Chiredzi Urban,,1822,6413,3456,2957,1958
170637,37,Midlands,Mberengwa,,1706,1530,833,697,317
170625,25,Midlands,Mberengwa,,1706,3582,2010,1572,752
170612,12,Midlands,Mberengwa,,1706,4297,2273,2024,922
180530,30,Masvingo,Masvingo,,1805,14976,7865,7111,2980
180329,29,Masvingo,Chivi,,1803,4722,2446,2276,925
180327,27,Masvingo,Chivi,,1803,4709,2518,2191,925
180208,8,Masvingo,Chiredzi,,1802,7905,4364,3541,1640
182203,3,Masvingo,Chiredzi Urban,,1822,4735,2509,2226,1299
180726,26,Masvingo,Zaka,,1807,4469,2472,1997,986
180528,28,Masvingo,Masvingo,,1805,5596,2998,2598,1200
110325,25,Manicaland,Chipinge,,1103,14165,7935,6230,2707
110328,28,Manicaland,Chipinge,,1103,19761,10642,9119,3868
150719,19,Matabeleland North,Umguza,,1507,4262,2082,2180,1077
160206,6,Matabeleland South,Bulilima,,1602,5011,2791,2220,1172
170232,32,Midlands,Gokwe North,,1702,2751,1411,1340,532
172201,1,Midlands,Kwekwe Urban,,1722,10903,5693,5210,2719
150703,3,Matabeleland North,Umguza,,1507,3907,2001,1906,758
150213,13,Matabeleland North,Bubi,,1502,2038,957,1081,511
180308,8,Masvingo,Chivi,,1803,4022,2166,1856,864
180533,33,Masvingo,Masvingo,,1805,5284,2533,2751,1482
112208,8,Manicaland,Rusape,,1122,4832,2627,2205,1414
172309,9,Midlands,Redcliff,,1723,2730,1476,1254,656
140222,22,Mashonaland West,Hurungwe,,1402,14909,7440,7469,3091
180734,34,Masvingo,Zaka,,1807,3920,2139,1781,838
180439,39,Masvingo,Gutu,,1804,2174,1181,993,548
110127,27,Manicaland,Buhera,,1101,8073,4244,3829,1774
110310,10,Manicaland,Chipinge,,1103,4086,2031,2055,871
150411,11,Matabeleland North,Lupane,,1504,5140,2681,2459,889
150406,6,Matabeleland North,Lupane,,1504,2769,1490,1279,484
150412,12,Matabeleland North,Lupane,,1504,3960,2023,1937,762
172305,5,Midlands,Redcliff,,1723,7146,3741,3405,1970
170402,2,Midlands,Gweru,,1704,4972,2741,2231,1096
170405,5,Midlands,Gweru,,1704,2171,1173,998,504
150528,28,Matabeleland North,Nkayi,,1505,5728,3054,2674,1186
150521,21,Matabeleland North,Nkayi,,1505,5367,2927,2440,1243
152108,8,Matabeleland North,Hwange Urban,,1521,9813,4989,4824,2585
152109,9,Matabeleland North,Hwange Urban,,1521,488,221,267,112
152104,4,Matabeleland North,Hwange Urban,,1521,1364,682,682,350
112107,7,Manicaland,Mutare Urban,,1121,7324,3949,3375,1729
170331,31,Midlands,Gokwe South,,1703,4224,2219,2005,819
170318,18,Midlands,Gokwe South,,1703,9039,4709,4330,1908
110506,6,Manicaland,Mutare,,1105,7578,3941,3637,1647
110507,7,Manicaland,Mutare,,1105,4506,2166,2340,1204
110525,25,Manicaland,Mutare,,1105,6003,3204,2799,1364
112106,6,Manicaland,Mutare Urban,,1121,5454,2914,2540,1360
112117,17,Manicaland,Mutare Urban,,1121,28425,14976,13449,7819
112204,4,Manicaland,Rusape,,1122,2881,1522,1359,813
112201,1,Manicaland,Rusape,,1122,4466,2459,2007,1113
112207,7,Manicaland,Rusape,,1122,833,460,373,227
150427,27,Matabeleland North,Lupane,,1504,3384,1738,1646,646
150307,7,Matabeleland North,Hwange,,1503,3578,1859,1719,834
150308,8,Matabeleland North,Hwange,,1503,1686,862,824,414
152102,2,Matabeleland North,Hwange Urban,,1521,850,435,415,160
150113,13,Matabeleland North,Binga,,1501,4091,2228,1863,1017
150310,10,Matabeleland North,Hwange,,1503,4587,2284,2303,1112
142512,12,Mashonaland West,Norton,,1425,8936,4632,4304,2293
150115,15,Matabeleland North,Binga,,1501,3708,2134,1574,791
142802,2,Mashonaland West,Sanyati,,1428,10069,4851,5218,2181
140121,21,Mashonaland West,Chegutu,,1401,4898,2381,2517,1216
142510,10,Mashonaland West,Norton,,1425,3460,1865,1595,878
130630,30,Mashonaland East,Murehwa,,1306,12674,7674,5000,2667
130608,8,Mashonaland East,Murehwa,,1306,9191,4711,4480,2181
130222,22,Mashonaland East,Goromonzi,,1302,7279,3507,3772,1970
130224,24,Mashonaland East,Goromonzi,,1302,5899,3030,2869,1523
130801,1,Mashonaland East,Seke,,1308,13543,6983,6560,3224
130223,23,Mashonaland East,Goromonzi,,1302,6139,3054,3085,1559
130221,21,Mashonaland East,Goromonzi,,1302,3486,1689,1797,943
130802,2,Mashonaland East,Seke,,1308,8359,4292,4067,1993
132601,1,Mashonaland East,Ruwa,,1326,6518,3365,3153,1692
132602,2,Mashonaland East,Ruwa,,1326,5373,2859,2514,1334
130807,7,Mashonaland East,Seke,,1308,4651,2415,2236,1101
130803,3,Mashonaland East,Seke,,1308,2935,1500,1435,682
130804,4,Mashonaland East,Seke,,1308,8264,4311,3953,1976
132607,7,Mashonaland East,Ruwa,,1326,4493,2388,2105,1031
130817,17,Mashonaland East,Seke,,1308,1985,1013,972,429
192304,4,Harare,Epworth,,1923,23352,11770,11582,6074
192111,11,Harare,Harare,,1921,20742,10623,10119,5061
192113,13,Harare,Harare,,1921,23209,11991,11218,5438
192302,2,Harare,Epworth,,1923,14896,7404,7492,4287
192207,7,Harare,Chitungwiza,,1922,7946,4190,3756,1844
192209,9,Harare,Chitungwiza,,1922,8181,4305,3876,1925
110401,1,Manicaland,Makoni,,1104,3973,2094,1879,1022
110405,5,Manicaland,Makoni,,1104,12420,6480,5940,3093
150122,22,Matabeleland North,Binga,,1501,2720,1315,1405,658
170219,19,Midlands,Gokwe North,,1702,6012,3120,2892,1289
170217,17,Midlands,Gokwe North,,1702,5293,2640,2653,1092
170216,16,Midlands,Gokwe North,,1702,4443,2270,2173,983
170206,6,Midlands,Gokwe North,,1702,4879,2510,2369,984
120433,33,Mashonaland Central,Mazowe,,1204,8255,4252,4003,2189
120111,11,Mashonaland Central,Bindura,,1201,4296,2229,2067,1004
120417,17,Mashonaland Central,Mazowe,,1204,5276,2742,2534,1316
120724,24,Mashonaland Central,Shamva,,1207,1424,713,711,368
130501,1,Mashonaland East,Mudzi,,1305,6790,3442,3348,1828
142407,7,Mashonaland West,Kariba Urban,,1424,854,446,408,233
142404,4,Mashonaland West,Kariba Urban,,1424,1679,878,801,408
120815,15,Mashonaland Central,Mbire,,1208,5162,2698,2464,1224
120804,4,Mashonaland Central,Mbire,,1208,7116,3587,3529,1578
120613,13,Mashonaland Central,Rushinga,,1206,2974,1568,1406,655
120624,24,Mashonaland Central,Rushinga,,1206,3031,1603,1428,858
120206,6,Mashonaland Central,Centenary,,1202,2139,1103,1036,482
150101,1,Matabeleland North,Binga,,1501,3678,1945,1733,887
150123,23,Matabeleland North,Binga,,1501,7065,3795,3270,1569
160214,14,Matabeleland South,Bulilima,,1602,5702,3028,2674,1285
160308,8,Matabeleland South,Mangwe,,1603,2096,1119,977,399
160620,20,Matabeleland South,Matobo,,1606,65,16,49,25
140201,1,Mashonaland West,Hurungwe,,1402,13934,6758,7176,3242
160102,2,Matabeleland South,Beitbridge,,1601,4940,2676,2264,1146
180215,15,Masvingo,Chiredzi,,1802,8467,4753,3714,1723
160302,2,Matabeleland South,Mangwe,,1603,4052,2199,1853,822
110330,30,Manicaland,Chipinge,,1103,3671,1950,1721,707
120801,1,Mashonaland Central,Mbire,,1208,3180,1622,1558,705
160513,13,Matabeleland South,Insiza,,1605,3292,1615,1677,784
180503,3,Masvingo,Masvingo,,1805,2743,1407,1336,635
160104,4,Matabeleland South,Beitbridge,,1601,5720,3127,2593,1280
150103,3,Matabeleland North,Binga,,1501,4697,2526,2171,1283
150117,17,Matabeleland North,Binga,,1501,10342,5560,4782,2155
150111,11,Matabeleland North,Binga,,1501,3373,1825,1548,874
160624,24,Matabeleland South,Matobo,,1606,2042,885,1157,539
120323,23,Mashonaland Central,Guruve,,1203,2804,1389,1415,616
180221,21,Masvingo,Chiredzi,,1802,10456,4807,5649,3040
180214,14,Masvingo,Chiredzi,,1802,8653,4876,3777,1848
160412,12,Matabeleland South,Gwanda,,1604,5119,2804,2315,1148
150114,14,Matabeleland North,Binga,,1501,7777,4140,3637,1720
150315,15,Matabeleland North,Hwange,,1503,4098,2171,1927,908
150602,2,Matabeleland North,Tsholotsho,,1506,4829,2556,2273,965
160111,11,Matabeleland South,Beitbridge,,1601,7082,3850,3232,1502
160419,19,Matabeleland South,Gwanda,,1604,5399,2902,2497,1231
160309,9,Matabeleland South,Mangwe,,1603,2365,1330,1035,498
110319,19,Manicaland,Chipinge,,1103,12939,6812,6127,2945
150711,11,Matabeleland North,Umguza,,1507,5301,2742,2559,1133
142804,4,Mashonaland West,Sanyati,,1428,8208,4075,4133,1722
120811,11,Mashonaland Central,Mbire,,1208,1638,809,829,332
160523,23,Matabeleland South,Insiza,,1605,4379,1902,2477,1312
170312,12,Midlands,Gokwe South,,1703,10906,5666,5240,2226
150221,21,Matabeleland North,Bubi,,1502,5190,2549,2641,1029
170314,14,Midlands,Gokwe South,,1703,10104,5153,4951,2024
142716,16,Mashonaland West,Mhondoro-Ngezi,,1427,5599,2757,2842,1046
170319,19,Midlands,Gokwe South,,1703,13989,7194,6795,2877
110434,34,Manicaland,Makoni,,1104,3877,1981,1896,836
170228,28,Midlands,Gokwe North,,1702,7993,4147,3846,1577
110413,13,Manicaland,Makoni,,1104,1412,632,780,345
140408,8,Mashonaland West,Kariba,,1404,5768,2961,2807,1165
170227,27,Midlands,Gokwe North,,1702,5781,2980,2801,1056
140403,3,Mashonaland West,Kariba,,1404,6072,3135,2937,1484
140209,9,Mashonaland West,Hurungwe,,1402,24424,12234,12190,5407
140220,20,Mashonaland West,Hurungwe,,1402,8099,3991,4108,1709
140519,19,Mashonaland West,Makonde,,1405,10178,5002,5176,2156
110704,4,Manicaland,Nyanga,,1107,7975,4218,3757,1978
120207,7,Mashonaland Central,Centenary,,1202,1297,661,636,287
160306,6,Matabeleland South,Mangwe,,1603,5634,3017,2617,1158
160316,16,Matabeleland South,Mangwe,,1603,6156,3492,2664,1225
160313,13,Matabeleland South,Mangwe,,1603,3401,1777,1624,650
180612,12,Masvingo,Mwenezi,,1806,5232,2887,2345,1028
180332,32,Masvingo,Chivi,,1803,5720,3132,2588,1264
180604,4,Masvingo,Mwenezi,,1806,5336,2858,2478,1169
180729,29,Masvingo,Zaka,,1807,3563,1956,1607,789
180226,26,Masvingo,Chiredzi,,1802,3020,1544,1476,669
180207,7,Masvingo,Chiredzi,,1802,7786,4392,3394,1557
110719,19,Manicaland,Nyanga,,1107,3834,2092,1742,926
140213,13,Mashonaland West,Hurungwe,,1402,22797,11626,11171,4840
150714,14,Matabeleland North,Umguza,,1507,4278,2055,2223,1077
150715,15,Matabeleland North,Umguza,,1507,3928,2245,1683,388
150419,19,Matabeleland North,Lupane,,1504,4228,2222,2006,810
170702,2,Midlands,Shurugwi,,1707,2641,1390,1251,533
150202,2,Matabeleland North,Bubi,,1502,2904,1489,1415,640
170115,15,Midlands,Chirumhanzu,,1701,4210,2090,2120,936
170516,16,Midlands,Kwekwe,,1705,4293,2283,2010,817
170501,1,Midlands,Kwekwe,,1705,4681,2202,2479,1017
130115,15,Mashonaland East,Chikomba,,1301,4700,2476,2224,1131
110509,9,Manicaland,Mutare,,1105,5985,3168,2817,1289
110519,19,Manicaland,Mutare,,1105,6380,3493,2887,1493
170231,31,Midlands,Gokwe North,,1702,7173,3867,3306,1531
170306,6,Midlands,Gokwe South,,1703,7138,3772,3366,1460
170235,35,Midlands,Gokwe North,,1702,7080,3670,3410,1507
170236,36,Midlands,Gokwe North,,1702,12320,6422,5898,2937
140126,26,Mashonaland West,Chegutu,,1401,3687,1733,1954,843
140405,5,Mashonaland West,Kariba,,1404,3152,1637,1515,689
140401,1,Mashonaland West,Kariba,,1404,1369,606,763,412
140411,11,Mashonaland West,Kariba,,1404,2538,1290,1248,530
140503,3,Mashonaland West,Makonde,,1405,3786,1871,1915,748
120220,20,Mashonaland Central,Centenary,,1202,1035,506,529,233
170120,20,Midlands,Chirumhanzu,,1701,8303,4174,4129,1880
